小	xi aa_l o_l
接	ji eh_h eh_h
听	ti el_h ng_h
挂	gu a_h a_l
断	du a_h nn_l
天	ti a_h nn_h
之	zh ib_h ib_h
之	z ib_h ib_h
眼	yi a_l nn_l
你	ni i_l i_h
你	li i_l i_h
你	yi i_l i_h
好	h aa_l o_l
你好	ni i_l i_h h aa_l o_l
你好	li i_l i_h h aa_l o_l
你好	ni aa_h o_l
猫      m aa_h o_h
猫      m aa_l o_h
精      ji el_h ng_h
灵      li el_l ng_h
灵      li el_m ng_m
电	di a_h nn_l
视	sh ib_h ib_l
视      s if_h if_l
小	xi aa_l o_l
云	yv el_l nn_h
斑	b a_h nn_h
马	m a_l a_l
上	sh aa_h ng_l
上	s aa_h ng_l
下	xi a_h a_l
一	yi i_h i_h
一	yi i_h i_l
一	yi i_m i_m
首	sh o_l u_l
首	s o_l u_l
放	f aa_h ng_l
大	d a_h a_l
地	di i_h i_l
图	tu u_l u_h
缩	su o_h o_h
小	xi aa_l o_l
打	d a_l a_l
开	k a_h eh_h
屏	pi el_l ng_h
幕	mu u_h u_l
关	gu a_h nn_h
闭	bi i_h i_l
增	z el_h ng_h
音	yi i_h nn_h
量	li aa_h ng_l
减	ji a_l nn_h
调	ti aa_l o_h
暗	a_h nn_l
亮	li aa_h ng_l
声	sh el_h ng_h
音	yi i_h nn_h
快	ku a_h eh_l
速	su u_h u_l
拍	p a_h eh_h
照	zh aa_h o_l
查	ch a_l a_h
查	c a_l a_h
看	k a_h nn_l
全	qv a_l nn_h
程	ch el_l ng_h
程	c el_l ng_h
程	ch el_l nn_h
程	c el_l nn_h
躲	du o_l o_l
避	bi i_h i_l
拥	yi u_h ng_h
堵	du u_l u_l
高	g aa_h o_h
速	su u_h u_l
优	yi o_h u_h
先	xi a_h nn_h
不	bu u_h u_l
走	z o_l u_l
避	bi i_h i_l
免	mi a_l nn_l
收	sh o_h u_h
费	f eh_h i_l
退	tu eh_h i_l
出	chu u_h u_h
导	d aa_l o_l
航	h aa_l ng_h
取	qv v_l v_l
消	xi aa_h o_h
暂	z a_h nn_l
停	ti el_l ng_h
播	bu o_h o_h
放	f aa_h ng_l
继	ji i_h i_l
续	xv v_h v_l
单	d a_h nn_h
曲	qv v_h v_h
循	xv el_l nn_h
环	hu a_l nn_h
列	li eh_h eh_l
表	bi aa_l o_l
随	su eh_l i_h
机	ji i_h i_h
模	mu o_l o_h
式	sh ib_h ib_l
乐	yv eh_h eh_l
完	wu a_l nn_h
毕	bi i_h i_l
回	hu eh_l i_h
复	fu u_h u_l
微	wu eh_h i_h
信	xi i_h nn_l
发	f a_h a_h
送	su u_h ng_l
取	qv v_l v_l
消	xi aa_h o_h
酷	ku u_h u_l
喵	mi aa_h o_h
家	ji a_h a_h
换	hu a_h nn_l
批	pi i_h i_h
集	ji i_l i_h
一集	ji i_l i_h
静	ji el_h ng_l
静	ji i_h nn_l
返	f a_l nn_l
桌	zhu o_h o_h
面	mi a_h nn_l
我      wu o_l o_l
要      yi aa_h o_h
要      yi aa_h o_l
看      k a_h nn_h
看      k a_h nn_l
听     ti el_h ng_h
上一首	sh aa_h ng_l yi i_h i_h sh o_l u_l
下一首	xi a_h a_l yi i_h i_l sh o_l u_l
放大地图	f aa_h ng_l d a_h a_l di i_h i_l tu u_l u_h
缩小地图	su o_h o_h xi aa_l o_l di i_h i_l tu u_l u_h
打开屏幕	d a_l a_l k a_h eh_h pi el_l ng_h mu u_h u_l
关闭屏幕	gu a_h nn_h bi i_h i_l pi el_l ng_h mu u_h u_l
增大音量	z el_h ng_h d a_h a_l yi i_h nn_h li aa_h ng_l
减小音量	ji a_l nn_h xi aa_l o_l yi i_h nn_h li aa_h ng_l
调暗屏幕	ti aa_l o_h a_h nn_l pi el_l ng_h mu u_h u_l
调亮屏幕	ti aa_l o_h li aa_h ng_l pi el_l ng_h mu u_h u_l
打开声音	d a_l a_l k a_h eh_h sh el_h ng_h yi i_h nn_h
关闭声音	gu a_h nn_h bi i_h i_l sh el_h ng_h yi i_h nn_h
快速拍照	ku a_h eh_l su u_h u_l p a_h eh_h zh aa_h o_l
2D切换	er_h er_l di i_h i_l qi eh_h eh_h hu a_h nn_l
3D切换	s a_h nn_h di i_h i_l qi eh_h eh_h hu a_h nn_l
路况查询	lu u_h u_l ku aa_h ng_l ch a_l a_h xv el_l nn_h
车头向上	ch el_h el_h t o_l u_h xi aa_h ng_l sh aa_h ng_l
北向上	b eh_l i_l xi aa_h ng_l sh aa_h ng_l
查看全程	ch a_l a_h k a_h nn_l qv a_l nn_h ch el_l ng_h
躲避拥堵	du o_l o_l bi i_h i_l yi u_h ng_h du u_l u_l
高速优先	g aa_h o_h su u_h u_l yi o_h u_h xi a_h nn_h
不走高速	bu u_h u_l z o_l u_l g aa_h o_h su u_h u_l
避免收费	bi i_h i_l mi a_l nn_l sh o_h u_h f eh_h i_l
还有多久	h a_l eh_h yi o_l u_l du o_h o_h ji o_l u_l
退出导航	tu eh_h i_l chu u_h u_h d aa_l o_l h aa_l ng_h
取消导航	qv v_l v_l xi aa_h o_h d aa_l o_l h aa_l ng_h
关闭导航	gu a_h nn_h bi i_h i_l d aa_l o_l h aa_l ng_h
暂停播放	z a_h nn_l ti el_l ng_h bu o_h o_h f aa_h ng_l
继续播放	ji i_h i_l xv v_h v_l bu o_h o_h f aa_h ng_l
单曲循环	d a_h nn_h qv v_h v_h xv el_l nn_h hu a_l nn_h
列表循环	li eh_h eh_l bi aa_l o_l xv el_l nn_h hu a_l nn_h
随机模式	su eh_l i_h ji i_h i_h mu o_l o_h sh ib_h ib_l
播放音乐	bu o_h o_h f aa_h ng_l yi i_h nn_h yv eh_h eh_l
完毕完毕	wu a_l nn_h bi i_h i_l wu a_l nn_h bi i_h i_l
回复微信	hu eh_l i_h fu u_h u_l wu eh_h i_h xi i_h nn_l
继续发送微信	ji i_h i_l xv v_h v_l f a_h a_h su u_h ng_l wu eh_h i_h xi i_h nn_l
取消取消	qv v_l v_l xi aa_h o_h qv v_l v_l xi aa_h o_h
PU	pu
NG_H	ng_h
TI	ti
RR	rr
NG_L	ng_l
NG_M	ng_m
CH	ch
ZHU	zhu
RU	ru
CHU	chu
TU	tu
XI	xi
CU	cu
AA_H	aa_h
ZH	zh
AA_L	aa_l
AA_M	aa_m
IB_H	ib_h
XV	xv
IB_L	ib_l
IB_M	ib_m
GU	gu
ZU	zu
I_H	i_h
MI	mi
I_L	i_l
I_M	i_m
KU	ku
O_H	o_h
MU	mu
O_L	o_l
O_M	o_m
NN_H	nn_h
QI	qi
EH_H	eh_h
NN_L	nn_l
NN_M	nn_m
EH_L	eh_l
U_H	u_h
EH_M	eh_m
SH	sh
U_L	u_l
U_M	u_m
BI	bi
QV	qv
A_H	a_h
A_L	a_l
DI	di
A_M	a_m
SU	su
IF_H	if_h
BU	bu
SHU	shu
IF_L	if_l
IF_M	if_m
YI	yi
DU	du
WU	wu
FU	fu
JI	ji
YV	yv
B	b
C	c
HU	hu
D	d
F	f
LI	li
G	g
V_H	v_h
H	h
EL_H	el_h
K	k
JV	jv
V_L	v_l
L	l
NI	ni
V_M	v_m
EL_L	el_l
M	m
N	n
EL_M	el_m
P	p
LU	lu
R	r
LV	lv
S	s
ER_H	er_h
T	t
PI	pi
ER_L	er_l
ER_M	er_m
NU	nu
NV	nv
Z	z
W_0	W_0
W_1	W_1
W_2	W_2
W_3	W_3
W_4	W_4
W_5	W_5
W_6	W_6
W_7	W_7
W_8	W_8
W_9	W_9
W_A	W_a
W_B	W_b
W_C	W_c
W_D	W_d
W_E	W_e
W_F	W_f
W_G	W_g
W_H	W_h
W_I	W_i
W_J	W_j
W_K	W_k
W_L	W_l
W_M	W_m
W_N	W_n
W_O	W_o
W_P	W_p
W_Q	W_q
W_R	W_r
W_S	W_s
W_T	W_t
W_U	W_u
W_V	W_v
W_W	W_w
W_X	W_x
W_Y	W_y
W_Z	W_z
A_1	a_h a_h
A_2	a_l a_h
A_3	a_l a_l
A_4	a_h a_l
A_5	a_m a_m
AI_1	a_h eh_h
AI_2	a_l eh_h
AI_3	a_l eh_l
AI_4	a_h eh_l
AI_5	a_m eh_m
AN_1	a_h nn_h
AN_2	a_l nn_h
AN_3	a_l nn_l
AN_4	a_h nn_l
AN_5	a_m nn_m
ANG_1	aa_h ng_h
ANG_2	aa_l ng_h
ANG_3	aa_l ng_l
ANG_4	aa_h ng_l
ANG_5	aa_m ng_m
AO_1	aa_h o_h
AO_2	aa_l o_h
AO_3	aa_l o_l
AO_4	aa_h o_l
AO_5	aa_m o_m
BA_1	b a_h a_h
BA_2	b a_l a_h
BA_3	b a_l a_l
BA_4	b a_h a_l
BA_5	b a_m a_m
BAI_1	b a_h eh_h
BAI_2	b a_l eh_h
BAI_3	b a_l eh_l
BAI_4	b a_h eh_l
BAI_5	b a_m eh_m
BAN_1	b a_h nn_h
BAN_2	b a_l nn_h
BAN_3	b a_l nn_l
BAN_4	b a_h nn_l
BAN_5	b a_m nn_m
BANG_1	b aa_h ng_h
BANG_2	b aa_l ng_h
BANG_3	b aa_l ng_l
BANG_4	b aa_h ng_l
BANG_5	b aa_m ng_m
BAO_1	b aa_h o_h
BAO_2	b aa_l o_h
BAO_3	b aa_l o_l
BAO_4	b aa_h o_l
BAO_5	b aa_m o_m
BEI_1	b eh_h i_h
BEI_2	b eh_l i_h
BEI_3	b eh_l i_l
BEI_4	b eh_h i_l
BEI_5	b eh_m i_m
BEN_1	b el_h nn_h
BEN_2	b el_l nn_h
BEN_3	b el_l nn_l
BEN_4	b el_h nn_l
BEN_5	b el_m nn_m
BENG_1	b el_h ng_h
BENG_2	b el_l ng_h
BENG_3	b el_l ng_l
BENG_4	b el_h ng_l
BENG_5	b el_m ng_m
BI_1	bi i_h i_h
BI_2	bi i_l i_h
BI_3	bi i_l i_l
BI_4	bi i_h i_l
BI_5	bi i_m i_m
BIAN_1	bi a_h nn_h
BIAN_2	bi a_l nn_h
BIAN_3	bi a_l nn_l
BIAN_4	bi a_h nn_l
BIAN_5	bi a_m nn_m
BIAO_1	bi aa_h o_h
BIAO_2	bi aa_l o_h
BIAO_3	bi aa_l o_l
BIAO_4	bi aa_h o_l
BIAO_5	bi aa_m o_m
BIE_1	bi eh_h eh_h
BIE_2	bi eh_l eh_h
BIE_3	bi eh_l eh_l
BIE_4	bi eh_h eh_l
BIE_5	bi eh_m eh_m
BIN_1	bi i_h nn_h
BIN_2	bi i_l nn_h
BIN_3	bi i_l nn_l
BIN_4	bi i_h nn_l
BIN_5	bi i_m nn_m
BING_1	bi el_h ng_h
BING_2	bi el_l ng_h
BING_3	bi el_l ng_l
BING_4	bi el_h ng_l
BING_5	bi el_m ng_m
BO_1	bu o_h o_h
BO_2	bu o_l o_h
BO_3	bu o_l o_l
BO_4	bu o_h o_l
BO_5	bu o_m o_m
BU_1	bu u_h u_h
BU_2	bu u_l u_h
BU_3	bu u_l u_l
BU_4	bu u_h u_l
BU_5	bu u_m u_m
CA_1	c a_h a_h
CA_2	c a_l a_h
CA_3	c a_l a_l
CA_4	c a_h a_l
CA_5	c a_m a_m
CAI_1	c a_h eh_h
CAI_2	c a_l eh_h
CAI_3	c a_l eh_l
CAI_4	c a_h eh_l
CAI_5	c a_m eh_m
CAN_1	c a_h nn_h
CAN_2	c a_l nn_h
CAN_3	c a_l nn_l
CAN_4	c a_h nn_l
CAN_5	c a_m nn_m
CANG_1	c aa_h ng_h
CANG_2	c aa_l ng_h
CANG_3	c aa_l ng_l
CANG_4	c aa_h ng_l
CANG_5	c aa_m ng_m
CAO_1	c aa_h o_h
CAO_2	c aa_l o_h
CAO_3	c aa_l o_l
CAO_4	c aa_h o_l
CAO_5	c aa_m o_m
CE_1	c el_h el_h
CE_2	c el_l el_h
CE_3	c el_l el_l
CE_4	c el_h el_l
CE_5	c el_m el_m
CEN_1	c el_h nn_h
CEN_2	c el_l nn_h
CEN_3	c el_l nn_l
CEN_4	c el_h nn_l
CEN_5	c el_m nn_m
CENG_1	c el_h ng_h
CENG_2	c el_l ng_h
CENG_3	c el_l ng_l
CENG_4	c el_h ng_l
CENG_5	c el_m ng_m
CHA_1	ch a_h a_h
CHA_2	ch a_l a_h
CHA_3	ch a_l a_l
CHA_4	ch a_h a_l
CHA_5	ch a_m a_m
CHAI_1	ch a_h eh_h
CHAI_2	ch a_l eh_h
CHAI_3	ch a_l eh_l
CHAI_4	ch a_h eh_l
CHAI_5	ch a_m eh_m
CHAN_1	ch a_h nn_h
CHAN_2	ch a_l nn_h
CHAN_3	ch a_l nn_l
CHAN_4	ch a_h nn_l
CHAN_5	ch a_m nn_m
CHANG_1	ch aa_h ng_h
CHANG_2	ch aa_l ng_h
CHANG_3	ch aa_l ng_l
CHANG_4	ch aa_h ng_l
CHANG_5	ch aa_m ng_m
CHAO_1	ch aa_h o_h
CHAO_2	ch aa_l o_h
CHAO_3	ch aa_l o_l
CHAO_4	ch aa_h o_l
CHAO_5	ch aa_m o_m
CHE_1	ch el_h el_h
CHE_2	ch el_l el_h
CHE_3	ch el_l el_l
CHE_4	ch el_h el_l
CHE_5	ch el_m el_m
CHEN_1	ch el_h nn_h
CHEN_2	ch el_l nn_h
CHEN_3	ch el_l nn_l
CHEN_4	ch el_h nn_l
CHEN_5	ch el_m nn_m
CHENG_1	ch el_h ng_h
CHENG_2	ch el_l ng_h
CHENG_3	ch el_l ng_l
CHENG_4	ch el_h ng_l
CHENG_5	ch el_m ng_m
CHI_1	ch ib_h ib_h
CHI_2	ch ib_l ib_h
CHI_3	ch ib_l ib_l
CHI_4	ch ib_h ib_l
CHI_5	ch ib_m ib_m
CHONG_1	chu u_h ng_h
CHONG_2	chu u_l ng_h
CHONG_3	chu u_l ng_l
CHONG_4	chu u_h ng_l
CHONG_5	chu u_m ng_m
CHOU_1	ch o_h u_h
CHOU_2	ch o_l u_h
CHOU_3	ch o_l u_l
CHOU_4	ch o_h u_l
CHOU_5	ch o_m u_m
CHU_1	chu u_h u_h
CHU_2	chu u_l u_h
CHU_3	chu u_l u_l
CHU_4	chu u_h u_l
CHU_5	chu u_m u_m
CHUA_1	chu a_h a_h
CHUA_2	chu a_l a_h
CHUA_3	chu a_l a_l
CHUA_4	chu a_h a_l
CHUA_5	chu a_m a_m
CHUAI_1	chu a_h eh_h
CHUAI_2	chu a_l eh_h
CHUAI_3	chu a_l eh_l
CHUAI_4	chu a_h eh_l
CHUAI_5	chu a_m eh_m
CHUAN_1	chu a_h nn_h
CHUAN_2	chu a_l nn_h
CHUAN_3	chu a_l nn_l
CHUAN_4	chu a_h nn_l
CHUAN_5	chu a_m nn_m
CHUANG_1	chu aa_h ng_h
CHUANG_2	chu aa_l ng_h
CHUANG_3	chu aa_l ng_l
CHUANG_4	chu aa_h ng_l
CHUANG_5	chu aa_m ng_m
CHUI_1	chu eh_h i_h
CHUI_2	chu eh_l i_h
CHUI_3	chu eh_l i_l
CHUI_4	chu eh_h i_l
CHUI_5	chu eh_m i_m
CHUN_1	chu el_h nn_h
CHUN_2	chu el_l nn_h
CHUN_3	chu el_l nn_l
CHUN_4	chu el_h nn_l
CHUN_5	chu el_m nn_m
CHUO_1	chu o_h o_h
CHUO_2	chu o_l o_h
CHUO_3	chu o_l o_l
CHUO_4	chu o_h o_l
CHUO_5	chu o_m o_m
CI_1	c if_h if_h
CI_2	c if_l if_h
CI_3	c if_l if_l
CI_4	c if_h if_l
CI_5	c if_m if_m
CONG_1	cu u_h ng_h
CONG_2	cu u_l ng_h
CONG_3	cu u_l ng_l
CONG_4	cu u_h ng_l
CONG_5	cu u_m ng_m
COU_1	c o_h u_h
COU_2	c o_l u_h
COU_3	c o_l u_l
COU_4	c o_h u_l
COU_5	c o_m u_m
CU_1	cu u_h u_h
CU_2	cu u_l u_h
CU_3	cu u_l u_l
CU_4	cu u_h u_l
CU_5	cu u_m u_m
CUAN_1	cu a_h nn_h
CUAN_2	cu a_l nn_h
CUAN_3	cu a_l nn_l
CUAN_4	cu a_h nn_l
CUAN_5	cu a_m nn_m
CUI_1	cu eh_h i_h
CUI_2	cu eh_l i_h
CUI_3	cu eh_l i_l
CUI_4	cu eh_h i_l
CUI_5	cu eh_m i_m
CUN_1	cu el_h nn_h
CUN_2	cu el_l nn_h
CUN_3	cu el_l nn_l
CUN_4	cu el_h nn_l
CUN_5	cu el_m nn_m
CUO_1	cu o_h o_h
CUO_2	cu o_l o_h
CUO_3	cu o_l o_l
CUO_4	cu o_h o_l
CUO_5	cu o_m o_m
DA_1	d a_h a_h
DA_2	d a_l a_h
DA_3	d a_l a_l
DA_4	d a_h a_l
DA_5	d a_m a_m
DAI_1	d a_h eh_h
DAI_2	d a_l eh_h
DAI_3	d a_l eh_l
DAI_4	d a_h eh_l
DAI_5	d a_m eh_m
DAN_1	d a_h nn_h
DAN_2	d a_l nn_h
DAN_3	d a_l nn_l
DAN_4	d a_h nn_l
DAN_5	d a_m nn_m
DANG_1	d aa_h ng_h
DANG_2	d aa_l ng_h
DANG_3	d aa_l ng_l
DANG_4	d aa_h ng_l
DANG_5	d aa_m ng_m
DAO_1	d aa_h o_h
DAO_2	d aa_l o_h
DAO_3	d aa_l o_l
DAO_4	d aa_h o_l
DAO_5	d aa_m o_m
DE_1	d el_h el_h
DE_2	d el_l el_h
DE_3	d el_l el_l
DE_4	d el_h el_l
DE_5	d el_m el_m
DEI_1	d eh_h i_h
DEI_2	d eh_l i_h
DEI_3	d eh_l i_l
DEI_4	d eh_h i_l
DEI_5	d eh_m i_m
DEN_1	d el_h nn_h
DEN_2	d el_l nn_h
DEN_3	d el_l nn_l
DEN_4	d el_h nn_l
DEN_5	d el_m nn_m
DENG_1	d el_h ng_h
DENG_2	d el_l ng_h
DENG_3	d el_l ng_l
DENG_4	d el_h ng_l
DENG_5	d el_m ng_m
DI_1	di i_h i_h
DI_2	di i_l i_h
DI_3	di i_l i_l
DI_4	di i_h i_l
DI_5	di i_m i_m
DIA_1	di a_h a_h
DIA_2	di a_l a_h
DIA_3	di a_l a_l
DIA_4	di a_h a_l
DIA_5	di a_m a_m
DIAN_1	di a_h nn_h
DIAN_2	di a_l nn_h
DIAN_3	di a_l nn_l
DIAN_4	di a_h nn_l
DIAN_5	di a_m nn_m
DIAO_1	di aa_h o_h
DIAO_2	di aa_l o_h
DIAO_3	di aa_l o_l
DIAO_4	di aa_h o_l
DIAO_5	di aa_m o_m
DIE_1	di eh_h eh_h
DIE_2	di eh_l eh_h
DIE_3	di eh_l eh_l
DIE_4	di eh_h eh_l
DIE_5	di eh_m eh_m
DING_1	di el_h ng_h
DING_2	di el_l ng_h
DING_3	di el_l ng_l
DING_4	di el_h ng_l
DING_5	di el_m ng_m
DIU_1	di o_h u_h
DIU_2	di o_l u_h
DIU_3	di o_l u_l
DIU_4	di o_h u_l
DIU_5	di o_m u_m
DONG_1	du u_h ng_h
DONG_2	du u_l ng_h
DONG_3	du u_l ng_l
DONG_4	du u_h ng_l
DONG_5	du u_m ng_m
DOU_1	d o_h u_h
DOU_2	d o_l u_h
DOU_3	d o_l u_l
DOU_4	d o_h u_l
DOU_5	d o_m u_m
DU_1	du u_h u_h
DU_2	du u_l u_h
DU_3	du u_l u_l
DU_4	du u_h u_l
DU_5	du u_m u_m
DUAN_1	du a_h nn_h
DUAN_2	du a_l nn_h
DUAN_3	du a_l nn_l
DUAN_4	du a_h nn_l
DUAN_5	du a_m nn_m
DUI_1	du eh_h i_h
DUI_2	du eh_l i_h
DUI_3	du eh_l i_l
DUI_4	du eh_h i_l
DUI_5	du eh_m i_m
DUN_1	du el_h nn_h
DUN_2	du el_l nn_h
DUN_3	du el_l nn_l
DUN_4	du el_h nn_l
DUN_5	du el_m nn_m
DUO_1	du o_h o_h
DUO_2	du o_l o_h
DUO_3	du o_l o_l
DUO_4	du o_h o_l
DUO_5	du o_m o_m
E_1	el_h el_h
E_2	el_l el_h
E_3	el_l el_l
E_4	el_h el_l
E_5	el_m el_m
EI_1	eh_h i_h
EI_2	eh_l i_h
EI_3	eh_l i_l
EI_4	eh_h i_l
EI_5	eh_m i_m
EN_1	el_h nn_h
EN_2	el_l nn_h
EN_3	el_l nn_l
EN_4	el_h nn_l
EN_5	el_m nn_m
ENG_1	el_h ng_h
ENG_2	el_l ng_h
ENG_3	el_l ng_l
ENG_4	el_h ng_l
ENG_5	el_m ng_m
ER_1	er_h er_h
ER_2	er_l er_h
ER_3	er_l er_l
ER_4	er_h er_l
ER_5	er_m er_m
FA_1	f a_h a_h
FA_2	f a_l a_h
FA_3	f a_l a_l
FA_4	f a_h a_l
FA_5	f a_m a_m
FAN_1	f a_h nn_h
FAN_2	f a_l nn_h
FAN_3	f a_l nn_l
FAN_4	f a_h nn_l
FAN_5	f a_m nn_m
FANG_1	f aa_h ng_h
FANG_2	f aa_l ng_h
FANG_3	f aa_l ng_l
FANG_4	f aa_h ng_l
FANG_5	f aa_m ng_m
FEI_1	f eh_h i_h
FEI_2	f eh_l i_h
FEI_3	f eh_l i_l
FEI_4	f eh_h i_l
FEI_5	f eh_m i_m
FEN_1	f el_h nn_h
FEN_2	f el_l nn_h
FEN_3	f el_l nn_l
FEN_4	f el_h nn_l
FEN_5	f el_m nn_m
FENG_1	f el_h ng_h
FENG_2	f el_l ng_h
FENG_3	f el_l ng_l
FENG_4	f el_h ng_l
FENG_5	f el_m ng_m
FO_1	fu o_h o_h
FO_2	fu o_l o_h
FO_3	fu o_l o_l
FO_4	fu o_h o_l
FO_5	fu o_m o_m
FOU_1	f o_h u_h
FOU_2	f o_l u_h
FOU_3	f o_l u_l
FOU_4	f o_h u_l
FOU_5	f o_m u_m
FU_1	fu u_h u_h
FU_2	fu u_l u_h
FU_3	fu u_l u_l
FU_4	fu u_h u_l
FU_5	fu u_m u_m
GA_1	g a_h a_h
GA_2	g a_l a_h
GA_3	g a_l a_l
GA_4	g a_h a_l
GA_5	g a_m a_m
GAI_1	g a_h eh_h
GAI_2	g a_l eh_h
GAI_3	g a_l eh_l
GAI_4	g a_h eh_l
GAI_5	g a_m eh_m
GAN_1	g a_h nn_h
GAN_2	g a_l nn_h
GAN_3	g a_l nn_l
GAN_4	g a_h nn_l
GAN_5	g a_m nn_m
GANG_1	g aa_h ng_h
GANG_2	g aa_l ng_h
GANG_3	g aa_l ng_l
GANG_4	g aa_h ng_l
GANG_5	g aa_m ng_m
GAO_1	g aa_h o_h
GAO_2	g aa_l o_h
GAO_3	g aa_l o_l
GAO_4	g aa_h o_l
GAO_5	g aa_m o_m
GE_1	g el_h el_h
GE_2	g el_l el_h
GE_3	g el_l el_l
GE_4	g el_h el_l
GE_5	g el_m el_m
GEI_1	g eh_h i_h
GEI_2	g eh_l i_h
GEI_3	g eh_l i_l
GEI_4	g eh_h i_l
GEI_5	g eh_m i_m
GEN_1	g el_h nn_h
GEN_2	g el_l nn_h
GEN_3	g el_l nn_l
GEN_4	g el_h nn_l
GEN_5	g el_m nn_m
GENG_1	g el_h ng_h
GENG_2	g el_l ng_h
GENG_3	g el_l ng_l
GENG_4	g el_h ng_l
GENG_5	g el_m ng_m
GONG_1	gu u_h ng_h
GONG_2	gu u_l ng_h
GONG_3	gu u_l ng_l
GONG_4	gu u_h ng_l
GONG_5	gu u_m ng_m
GOU_1	g o_h u_h
GOU_2	g o_l u_h
GOU_3	g o_l u_l
GOU_4	g o_h u_l
GOU_5	g o_m u_m
GU_1	gu u_h u_h
GU_2	gu u_l u_h
GU_3	gu u_l u_l
GU_4	gu u_h u_l
GU_5	gu u_m u_m
GUA_1	gu a_h a_h
GUA_2	gu a_l a_h
GUA_3	gu a_l a_l
GUA_4	gu a_h a_l
GUA_5	gu a_m a_m
GUAI_1	gu a_h eh_h
GUAI_2	gu a_l eh_h
GUAI_3	gu a_l eh_l
GUAI_4	gu a_h eh_l
GUAI_5	gu a_m eh_m
GUAN_1	gu a_h nn_h
GUAN_2	gu a_l nn_h
GUAN_3	gu a_l nn_l
GUAN_4	gu a_h nn_l
GUAN_5	gu a_m nn_m
GUANG_1	gu aa_h ng_h
GUANG_2	gu aa_l ng_h
GUANG_3	gu aa_l ng_l
GUANG_4	gu aa_h ng_l
GUANG_5	gu aa_m ng_m
GUI_1	gu eh_h i_h
GUI_2	gu eh_l i_h
GUI_3	gu eh_l i_l
GUI_4	gu eh_h i_l
GUI_5	gu eh_m i_m
GUN_1	gu el_h nn_h
GUN_2	gu el_l nn_h
GUN_3	gu el_l nn_l
GUN_4	gu el_h nn_l
GUN_5	gu el_m nn_m
GUO_1	gu o_h o_h
GUO_2	gu o_l o_h
GUO_3	gu o_l o_l
GUO_4	gu o_h o_l
GUO_5	gu o_m o_m
HA_1	h a_h a_h
HA_2	h a_l a_h
HA_3	h a_l a_l
HA_4	h a_h a_l
HA_5	h a_m a_m
HAI_1	h a_h eh_h
HAI_2	h a_l eh_h
HAI_3	h a_l eh_l
HAI_4	h a_h eh_l
HAI_5	h a_m eh_m
HAN_1	h a_h nn_h
HAN_2	h a_l nn_h
HAN_3	h a_l nn_l
HAN_4	h a_h nn_l
HAN_5	h a_m nn_m
HANG_1	h aa_h ng_h
HANG_2	h aa_l ng_h
HANG_3	h aa_l ng_l
HANG_4	h aa_h ng_l
HANG_5	h aa_m ng_m
HAO_1	h aa_h o_h
HAO_2	h aa_l o_h
HAO_3	h aa_l o_l
HAO_4	h aa_h o_l
HAO_5	h aa_m o_m
HE_1	h el_h el_h
HE_2	h el_l el_h
HE_3	h el_l el_l
HE_4	h el_h el_l
HE_5	h el_m el_m
HEI_1	h eh_h i_h
HEI_2	h eh_l i_h
HEI_3	h eh_l i_l
HEI_4	h eh_h i_l
HEI_5	h eh_m i_m
HEN_1	h el_h nn_h
HEN_2	h el_l nn_h
HEN_3	h el_l nn_l
HEN_4	h el_h nn_l
HEN_5	h el_m nn_m
HENG_1	h el_h ng_h
HENG_2	h el_l ng_h
HENG_3	h el_l ng_l
HENG_4	h el_h ng_l
HENG_5	h el_m ng_m
HONG_1	hu u_h ng_h
HONG_2	hu u_l ng_h
HONG_3	hu u_l ng_l
HONG_4	hu u_h ng_l
HONG_5	hu u_m ng_m
HOU_1	h o_h u_h
HOU_2	h o_l u_h
HOU_3	h o_l u_l
HOU_4	h o_h u_l
HOU_5	h o_m u_m
HU_1	hu u_h u_h
HU_2	hu u_l u_h
HU_3	hu u_l u_l
HU_4	hu u_h u_l
HU_5	hu u_m u_m
HUA_1	hu a_h a_h
HUA_2	hu a_l a_h
HUA_3	hu a_l a_l
HUA_4	hu a_h a_l
HUA_5	hu a_m a_m
HUAI_1	hu a_h eh_h
HUAI_2	hu a_l eh_h
HUAI_3	hu a_l eh_l
HUAI_4	hu a_h eh_l
HUAI_5	hu a_m eh_m
HUAN_1	hu a_h nn_h
HUAN_2	hu a_l nn_h
HUAN_3	hu a_l nn_l
HUAN_4	hu a_h nn_l
HUAN_5	hu a_m nn_m
HUANG_1	hu aa_h ng_h
HUANG_2	hu aa_l ng_h
HUANG_3	hu aa_l ng_l
HUANG_4	hu aa_h ng_l
HUANG_5	hu aa_m ng_m
HUI_1	hu eh_h i_h
HUI_2	hu eh_l i_h
HUI_3	hu eh_l i_l
HUI_4	hu eh_h i_l
HUI_5	hu eh_m i_m
HUN_1	hu el_h nn_h
HUN_2	hu el_l nn_h
HUN_3	hu el_l nn_l
HUN_4	hu el_h nn_l
HUN_5	hu el_m nn_m
HUO_1	hu o_h o_h
HUO_2	hu o_l o_h
HUO_3	hu o_l o_l
HUO_4	hu o_h o_l
HUO_5	hu o_m o_m
JI_1	ji i_h i_h
JI_2	ji i_l i_h
JI_3	ji i_l i_l
JI_4	ji i_h i_l
JI_5	ji i_m i_m
JIA_1	ji a_h a_h
JIA_2	ji a_l a_h
JIA_3	ji a_l a_l
JIA_4	ji a_h a_l
JIA_5	ji a_m a_m
JIAN_1	ji a_h nn_h
JIAN_2	ji a_l nn_h
JIAN_3	ji a_l nn_l
JIAN_4	ji a_h nn_l
JIAN_5	ji a_m nn_m
JIANG_1	ji aa_h ng_h
JIANG_2	ji aa_l ng_h
JIANG_3	ji aa_l ng_l
JIANG_4	ji aa_h ng_l
JIANG_5	ji aa_m ng_m
JIAO_1	ji aa_h o_h
JIAO_2	ji aa_l o_h
JIAO_3	ji aa_l o_l
JIAO_4	ji aa_h o_l
JIAO_5	ji aa_m o_m
JIE_1	ji eh_h eh_h
JIE_2	ji eh_l eh_h
JIE_3	ji eh_l eh_l
JIE_4	ji eh_h eh_l
JIE_5	ji eh_m eh_m
JIN_1	ji i_h nn_h
JIN_2	ji i_l nn_h
JIN_3	ji i_l nn_l
JIN_4	ji i_h nn_l
JIN_5	ji i_m nn_m
JING_1	ji el_h ng_h
JING_2	ji el_l ng_h
JING_3	ji el_l ng_l
JING_4	ji el_h ng_l
JING_5	ji el_m ng_m
JIONG_1	jv u_h ng_h
JIONG_2	jv u_l ng_h
JIONG_3	jv u_l ng_l
JIONG_4	jv u_h ng_l
JIONG_5	jv u_m ng_m
JIU_1	ji o_h u_h
JIU_2	ji o_l u_h
JIU_3	ji o_l u_l
JIU_4	ji o_h u_l
JIU_5	ji o_m u_m
JV_1	jv v_h v_h
JV_2	jv v_l v_h
JV_3	jv v_l v_l
JV_4	jv v_h v_l
JV_5	jv v_m v_m
JVAN_1	jv a_h nn_h
JVAN_2	jv a_l nn_h
JVAN_3	jv a_l nn_l
JVAN_4	jv a_h nn_l
JVAN_5	jv a_m nn_m
JVE_1	jv eh_h eh_h
JVE_2	jv eh_l eh_h
JVE_3	jv eh_l eh_l
JVE_4	jv eh_h eh_l
JVE_5	jv eh_m eh_m
JVN_1	jv el_h nn_h
JVN_2	jv el_l nn_h
JVN_3	jv el_l nn_l
JVN_4	jv el_h nn_l
JVN_5	jv el_m nn_m
KA_1	k a_h a_h
KA_2	k a_l a_h
KA_3	k a_l a_l
KA_4	k a_h a_l
KA_5	k a_m a_m
KAI_1	k a_h eh_h
KAI_2	k a_l eh_h
KAI_3	k a_l eh_l
KAI_4	k a_h eh_l
KAI_5	k a_m eh_m
KAN_1	k a_h nn_h
KAN_2	k a_l nn_h
KAN_3	k a_l nn_l
KAN_4	k a_h nn_l
KAN_5	k a_m nn_m
KANG_1	k aa_h ng_h
KANG_2	k aa_l ng_h
KANG_3	k aa_l ng_l
KANG_4	k aa_h ng_l
KANG_5	k aa_m ng_m
KAO_1	k aa_h o_h
KAO_2	k aa_l o_h
KAO_3	k aa_l o_l
KAO_4	k aa_h o_l
KAO_5	k aa_m o_m
KE_1	k el_h el_h
KE_2	k el_l el_h
KE_3	k el_l el_l
KE_4	k el_h el_l
KE_5	k el_m el_m
KEI_1	k eh_h i_h
KEI_2	k eh_l i_h
KEI_3	k eh_l i_l
KEI_4	k eh_h i_l
KEI_5	k eh_m i_m
KEN_1	k el_h nn_h
KEN_2	k el_l nn_h
KEN_3	k el_l nn_l
KEN_4	k el_h nn_l
KEN_5	k el_m nn_m
KENG_1	k el_h ng_h
KENG_2	k el_l ng_h
KENG_3	k el_l ng_l
KENG_4	k el_h ng_l
KENG_5	k el_m ng_m
KONG_1	ku u_h ng_h
KONG_2	ku u_l ng_h
KONG_3	ku u_l ng_l
KONG_4	ku u_h ng_l
KONG_5	ku u_m ng_m
KOU_1	k o_h u_h
KOU_2	k o_l u_h
KOU_3	k o_l u_l
KOU_4	k o_h u_l
KOU_5	k o_m u_m
KU_1	ku u_h u_h
KU_2	ku u_l u_h
KU_3	ku u_l u_l
KU_4	ku u_h u_l
KU_5	ku u_m u_m
KUA_1	ku a_h a_h
KUA_2	ku a_l a_h
KUA_3	ku a_l a_l
KUA_4	ku a_h a_l
KUA_5	ku a_m a_m
KUAI_1	ku a_h eh_h
KUAI_2	ku a_l eh_h
KUAI_3	ku a_l eh_l
KUAI_4	ku a_h eh_l
KUAI_5	ku a_m eh_m
KUAN_1	ku a_h nn_h
KUAN_2	ku a_l nn_h
KUAN_3	ku a_l nn_l
KUAN_4	ku a_h nn_l
KUAN_5	ku a_m nn_m
KUANG_1	ku aa_h ng_h
KUANG_2	ku aa_l ng_h
KUANG_3	ku aa_l ng_l
KUANG_4	ku aa_h ng_l
KUANG_5	ku aa_m ng_m
KUI_1	ku eh_h i_h
KUI_2	ku eh_l i_h
KUI_3	ku eh_l i_l
KUI_4	ku eh_h i_l
KUI_5	ku eh_m i_m
KUN_1	ku el_h nn_h
KUN_2	ku el_l nn_h
KUN_3	ku el_l nn_l
KUN_4	ku el_h nn_l
KUN_5	ku el_m nn_m
KUO_1	ku o_h o_h
KUO_2	ku o_l o_h
KUO_3	ku o_l o_l
KUO_4	ku o_h o_l
KUO_5	ku o_m o_m
LA_1	l a_h a_h
LA_2	l a_l a_h
LA_3	l a_l a_l
LA_4	l a_h a_l
LA_5	l a_m a_m
LAI_1	l a_h eh_h
LAI_2	l a_l eh_h
LAI_3	l a_l eh_l
LAI_4	l a_h eh_l
LAI_5	l a_m eh_m
LAN_1	l a_h nn_h
LAN_2	l a_l nn_h
LAN_3	l a_l nn_l
LAN_4	l a_h nn_l
LAN_5	l a_m nn_m
LANG_1	l aa_h ng_h
LANG_2	l aa_l ng_h
LANG_3	l aa_l ng_l
LANG_4	l aa_h ng_l
LANG_5	l aa_m ng_m
LAO_1	l aa_h o_h
LAO_2	l aa_l o_h
LAO_3	l aa_l o_l
LAO_4	l aa_h o_l
LAO_5	l aa_m o_m
LE_1	l el_h el_h
LE_2	l el_l el_h
LE_3	l el_l el_l
LE_4	l el_h el_l
LE_5	l el_m el_m
LEI_1	l eh_h i_h
LEI_2	l eh_l i_h
LEI_3	l eh_l i_l
LEI_4	l eh_h i_l
LEI_5	l eh_m i_m
LENG_1	l el_h ng_h
LENG_2	l el_l ng_h
LENG_3	l el_l ng_l
LENG_4	l el_h ng_l
LENG_5	l el_m ng_m
LI_1	li i_h i_h
LI_2	li i_l i_h
LI_3	li i_l i_l
LI_4	li i_h i_l
LI_5	li i_m i_m
LIA_1	li a_h a_h
LIA_2	li a_l a_h
LIA_3	li a_l a_l
LIA_4	li a_h a_l
LIA_5	li a_m a_m
LIAN_1	li a_h nn_h
LIAN_2	li a_l nn_h
LIAN_3	li a_l nn_l
LIAN_4	li a_h nn_l
LIAN_5	li a_m nn_m
LIANG_1	li aa_h ng_h
LIANG_2	li aa_l ng_h
LIANG_3	li aa_l ng_l
LIANG_4	li aa_h ng_l
LIANG_5	li aa_m ng_m
LIAO_1	li aa_h o_h
LIAO_2	li aa_l o_h
LIAO_3	li aa_l o_l
LIAO_4	li aa_h o_l
LIAO_5	li aa_m o_m
LIE_1	li eh_h eh_h
LIE_2	li eh_l eh_h
LIE_3	li eh_l eh_l
LIE_4	li eh_h eh_l
LIE_5	li eh_m eh_m
LIN_1	li i_h nn_h
LIN_2	li i_l nn_h
LIN_3	li i_l nn_l
LIN_4	li i_h nn_l
LIN_5	li i_m nn_m
LING_1	li el_h ng_h
LING_2	li el_l ng_h
LING_3	li el_l ng_l
LING_4	li el_h ng_l
LING_5	li el_m ng_m
LIU_1	li o_h u_h
LIU_2	li o_l u_h
LIU_3	li o_l u_l
LIU_4	li o_h u_l
LIU_5	li o_m u_m
LO_1	l o_h o_h
LO_2	l o_l o_h
LO_3	l o_l o_l
LO_4	l o_h o_l
LO_5	l o_m o_m
LONG_1	lu u_h ng_h
LONG_2	lu u_l ng_h
LONG_3	lu u_l ng_l
LONG_4	lu u_h ng_l
LONG_5	lu u_m ng_m
LOU_1	l o_h u_h
LOU_2	l o_l u_h
LOU_3	l o_l u_l
LOU_4	l o_h u_l
LOU_5	l o_m u_m
LU_1	lu u_h u_h
LU_2	lu u_l u_h
LU_3	lu u_l u_l
LU_4	lu u_h u_l
LU_5	lu u_m u_m
LUAN_1	lu a_h nn_h
LUAN_2	lu a_l nn_h
LUAN_3	lu a_l nn_l
LUAN_4	lu a_h nn_l
LUAN_5	lu a_m nn_m
LVE_1	lv eh_h eh_h
LVE_2	lv eh_l eh_h
LVE_3	lv eh_l eh_l
LVE_4	lv eh_h eh_l
LVE_5	lv eh_m eh_m
LUN_1	lu el_h nn_h
LUN_2	lu el_l nn_h
LUN_3	lu el_l nn_l
LUN_4	lu el_h nn_l
LUN_5	lu el_m nn_m
LUO_1	lu o_h o_h
LUO_2	lu o_l o_h
LUO_3	lu o_l o_l
LUO_4	lu o_h o_l
LUO_5	lu o_m o_m
LV_1	lv v_h v_h
LV_2	lv v_l v_h
LV_3	lv v_l v_l
LV_4	lv v_h v_l
LV_5	lv v_m v_m
MA_1	m a_h a_h
MA_2	m a_l a_h
MA_3	m a_l a_l
MA_4	m a_h a_l
MA_5	m a_m a_m
MAI_1	m a_h eh_h
MAI_2	m a_l eh_h
MAI_3	m a_l eh_l
MAI_4	m a_h eh_l
MAI_5	m a_m eh_m
MAN_1	m a_h nn_h
MAN_2	m a_l nn_h
MAN_3	m a_l nn_l
MAN_4	m a_h nn_l
MAN_5	m a_m nn_m
MANG_1	m aa_h ng_h
MANG_2	m aa_l ng_h
MANG_3	m aa_l ng_l
MANG_4	m aa_h ng_l
MANG_5	m aa_m ng_m
MAO_1	m aa_h o_h
MAO_2	m aa_l o_h
MAO_3	m aa_l o_l
MAO_4	m aa_h o_l
MAO_5	m aa_m o_m
ME_1	m el_h el_h
ME_2	m el_l el_h
ME_3	m el_l el_l
ME_4	m el_h el_l
ME_5	m el_m el_m
MEI_1	m eh_h i_h
MEI_2	m eh_l i_h
MEI_3	m eh_l i_l
MEI_4	m eh_h i_l
MEI_5	m eh_m i_m
MEN_1	m el_h nn_h
MEN_2	m el_l nn_h
MEN_3	m el_l nn_l
MEN_4	m el_h nn_l
MEN_5	m el_m nn_m
MENG_1	m el_h ng_h
MENG_2	m el_l ng_h
MENG_3	m el_l ng_l
MENG_4	m el_h ng_l
MENG_5	m el_m ng_m
MI_1	mi i_h i_h
MI_2	mi i_l i_h
MI_3	mi i_l i_l
MI_4	mi i_h i_l
MI_5	mi i_m i_m
MIAN_1	mi a_h nn_h
MIAN_2	mi a_l nn_h
MIAN_3	mi a_l nn_l
MIAN_4	mi a_h nn_l
MIAN_5	mi a_m nn_m
MIAO_1	mi aa_h o_h
MIAO_2	mi aa_l o_h
MIAO_3	mi aa_l o_l
MIAO_4	mi aa_h o_l
MIAO_5	mi aa_m o_m
MIE_1	mi eh_h eh_h
MIE_2	mi eh_l eh_h
MIE_3	mi eh_l eh_l
MIE_4	mi eh_h eh_l
MIE_5	mi eh_m eh_m
MIN_1	mi i_h nn_h
MIN_2	mi i_l nn_h
MIN_3	mi i_l nn_l
MIN_4	mi i_h nn_l
MIN_5	mi i_m nn_m
MING_1	mi el_h ng_h
MING_2	mi el_l ng_h
MING_3	mi el_l ng_l
MING_4	mi el_h ng_l
MING_5	mi el_m ng_m
MIU_1	mi o_h u_h
MIU_2	mi o_l u_h
MIU_3	mi o_l u_l
MIU_4	mi o_h u_l
MIU_5	mi o_m u_m
MO_1	mu o_h o_h
MO_2	mu o_l o_h
MO_3	mu o_l o_l
MO_4	mu o_h o_l
MO_5	mu o_m o_m
MOU_1	m o_h u_h
MOU_2	m o_l u_h
MOU_3	m o_l u_l
MOU_4	m o_h u_l
MOU_5	m o_m u_m
MU_1	mu u_h u_h
MU_2	mu u_l u_h
MU_3	mu u_l u_l
MU_4	mu u_h u_l
MU_5	mu u_m u_m
NA_1	n a_h a_h
NA_2	n a_l a_h
NA_3	n a_l a_l
NA_4	n a_h a_l
NA_5	n a_m a_m
NAI_1	n a_h eh_h
NAI_2	n a_l eh_h
NAI_3	n a_l eh_l
NAI_4	n a_h eh_l
NAI_5	n a_m eh_m
NAN_1	n a_h nn_h
NAN_2	n a_l nn_h
NAN_3	n a_l nn_l
NAN_4	n a_h nn_l
NAN_5	n a_m nn_m
NANG_1	n aa_h ng_h
NANG_2	n aa_l ng_h
NANG_3	n aa_l ng_l
NANG_4	n aa_h ng_l
NANG_5	n aa_m ng_m
NAO_1	n aa_h o_h
NAO_2	n aa_l o_h
NAO_3	n aa_l o_l
NAO_4	n aa_h o_l
NAO_5	n aa_m o_m
NE_1	n el_h el_h
NE_2	n el_l el_h
NE_3	n el_l el_l
NE_4	n el_h el_l
NE_5	n el_m el_m
NEI_1	n eh_h i_h
NEI_2	n eh_l i_h
NEI_3	n eh_l i_l
NEI_4	n eh_h i_l
NEI_5	n eh_m i_m
NEN_1	n el_h nn_h
NEN_2	n el_l nn_h
NEN_3	n el_l nn_l
NEN_4	n el_h nn_l
NEN_5	n el_m nn_m
NENG_1	n el_h ng_h
NENG_2	n el_l ng_h
NENG_3	n el_l ng_l
NENG_4	n el_h ng_l
NENG_5	n el_m ng_m
NI_1	ni i_h i_h
NI_2	ni i_l i_h
NI_3	ni i_l i_l
NI_4	ni i_h i_l
NI_5	ni i_m i_m
NIAN_1	ni a_h nn_h
NIAN_2	ni a_l nn_h
NIAN_3	ni a_l nn_l
NIAN_4	ni a_h nn_l
NIAN_5	ni a_m nn_m
NIANG_1	ni aa_h ng_h
NIANG_2	ni aa_l ng_h
NIANG_3	ni aa_l ng_l
NIANG_4	ni aa_h ng_l
NIANG_5	ni aa_m ng_m
NIAO_1	ni aa_h o_h
NIAO_2	ni aa_l o_h
NIAO_3	ni aa_l o_l
NIAO_4	ni aa_h o_l
NIAO_5	ni aa_m o_m
NIE_1	ni eh_h eh_h
NIE_2	ni eh_l eh_h
NIE_3	ni eh_l eh_l
NIE_4	ni eh_h eh_l
NIE_5	ni eh_m eh_m
NIN_1	ni i_h nn_h
NIN_2	ni i_l nn_h
NIN_3	ni i_l nn_l
NIN_4	ni i_h nn_l
NIN_5	ni i_m nn_m
NING_1	ni el_h ng_h
NING_2	ni el_l ng_h
NING_3	ni el_l ng_l
NING_4	ni el_h ng_l
NING_5	ni el_m ng_m
NIU_1	ni o_h u_h
NIU_2	ni o_l u_h
NIU_3	ni o_l u_l
NIU_4	ni o_h u_l
NIU_5	ni o_m u_m
NONG_1	nu u_h ng_h
NONG_2	nu u_l ng_h
NONG_3	nu u_l ng_l
NONG_4	nu u_h ng_l
NONG_5	nu u_m ng_m
NOU_1	n o_h u_h
NOU_2	n o_l u_h
NOU_3	n o_l u_l
NOU_4	n o_h u_l
NOU_5	n o_m u_m
NU_1	nu u_h u_h
NU_2	nu u_l u_h
NU_3	nu u_l u_l
NU_4	nu u_h u_l
NU_5	nu u_m u_m
NUAN_1	nu a_h nn_h
NUAN_2	nu a_l nn_h
NUAN_3	nu a_l nn_l
NUAN_4	nu a_h nn_l
NUAN_5	nu a_m nn_m
NVE_1	nv eh_h eh_h
NVE_2	nv eh_l eh_h
NVE_3	nv eh_l eh_l
NVE_4	nv eh_h eh_l
NVE_5	nv eh_m eh_m
NUN_1	nu el_h nn_h
NUN_2	nu el_l nn_h
NUN_3	nu el_l nn_l
NUN_4	nu el_h nn_l
NUN_5	nu el_m nn_m
NUO_1	nu o_h o_h
NUO_2	nu o_l o_h
NUO_3	nu o_l o_l
NUO_4	nu o_h o_l
NUO_5	nu o_m o_m
NV_1	nv v_h v_h
NV_2	nv v_l v_h
NV_3	nv v_l v_l
NV_4	nv v_h v_l
NV_5	nv v_m v_m
O_1	o_h o_h
O_2	o_l o_h
O_3	o_l o_l
O_4	o_h o_l
O_5	o_m o_m
OU_1	o_h u_h
OU_2	o_l u_h
OU_3	o_l u_l
OU_4	o_h u_l
OU_5	o_m u_m
PA_1	p a_h a_h
PA_2	p a_l a_h
PA_3	p a_l a_l
PA_4	p a_h a_l
PA_5	p a_m a_m
PAI_1	p a_h eh_h
PAI_2	p a_l eh_h
PAI_3	p a_l eh_l
PAI_4	p a_h eh_l
PAI_5	p a_m eh_m
PAN_1	p a_h nn_h
PAN_2	p a_l nn_h
PAN_3	p a_l nn_l
PAN_4	p a_h nn_l
PAN_5	p a_m nn_m
PANG_1	p aa_h ng_h
PANG_2	p aa_l ng_h
PANG_3	p aa_l ng_l
PANG_4	p aa_h ng_l
PANG_5	p aa_m ng_m
PAO_1	p aa_h o_h
PAO_2	p aa_l o_h
PAO_3	p aa_l o_l
PAO_4	p aa_h o_l
PAO_5	p aa_m o_m
PEI_1	p eh_h i_h
PEI_2	p eh_l i_h
PEI_3	p eh_l i_l
PEI_4	p eh_h i_l
PEI_5	p eh_m i_m
PEN_1	p el_h nn_h
PEN_2	p el_l nn_h
PEN_3	p el_l nn_l
PEN_4	p el_h nn_l
PEN_5	p el_m nn_m
PENG_1	p el_h ng_h
PENG_2	p el_l ng_h
PENG_3	p el_l ng_l
PENG_4	p el_h ng_l
PENG_5	p el_m ng_m
PI_1	pi i_h i_h
PI_2	pi i_l i_h
PI_3	pi i_l i_l
PI_4	pi i_h i_l
PI_5	pi i_m i_m
PIAN_1	pi a_h nn_h
PIAN_2	pi a_l nn_h
PIAN_3	pi a_l nn_l
PIAN_4	pi a_h nn_l
PIAN_5	pi a_m nn_m
PIAO_1	pi aa_h o_h
PIAO_2	pi aa_l o_h
PIAO_3	pi aa_l o_l
PIAO_4	pi aa_h o_l
PIAO_5	pi aa_m o_m
PIE_1	pi eh_h eh_h
PIE_2	pi eh_l eh_h
PIE_3	pi eh_l eh_l
PIE_4	pi eh_h eh_l
PIE_5	pi eh_m eh_m
PIN_1	pi i_h nn_h
PIN_2	pi i_l nn_h
PIN_3	pi i_l nn_l
PIN_4	pi i_h nn_l
PIN_5	pi i_m nn_m
PING_1	pi el_h ng_h
PING_2	pi el_l ng_h
PING_3	pi el_l ng_l
PING_4	pi el_h ng_l
PING_5	pi el_m ng_m
PO_1	pu o_h o_h
PO_2	pu o_l o_h
PO_3	pu o_l o_l
PO_4	pu o_h o_l
PO_5	pu o_m o_m
POU_1	p o_h u_h
POU_2	p o_l u_h
POU_3	p o_l u_l
POU_4	p o_h u_l
POU_5	p o_m u_m
PU_1	pu u_h u_h
PU_2	pu u_l u_h
PU_3	pu u_l u_l
PU_4	pu u_h u_l
PU_5	pu u_m u_m
QI_1	qi i_h i_h
QI_2	qi i_l i_h
QI_3	qi i_l i_l
QI_4	qi i_h i_l
QI_5	qi i_m i_m
QIA_1	qi a_h a_h
QIA_2	qi a_l a_h
QIA_3	qi a_l a_l
QIA_4	qi a_h a_l
QIA_5	qi a_m a_m
QIAN_1	qi a_h nn_h
QIAN_2	qi a_l nn_h
QIAN_3	qi a_l nn_l
QIAN_4	qi a_h nn_l
QIAN_5	qi a_m nn_m
QIANG_1	qi aa_h ng_h
QIANG_2	qi aa_l ng_h
QIANG_3	qi aa_l ng_l
QIANG_4	qi aa_h ng_l
QIANG_5	qi aa_m ng_m
QIAO_1	qi aa_h o_h
QIAO_2	qi aa_l o_h
QIAO_3	qi aa_l o_l
QIAO_4	qi aa_h o_l
QIAO_5	qi aa_m o_m
QIE_1	qi eh_h eh_h
QIE_2	qi eh_l eh_h
QIE_3	qi eh_l eh_l
QIE_4	qi eh_h eh_l
QIE_5	qi eh_m eh_m
QIN_1	qi i_h nn_h
QIN_2	qi i_l nn_h
QIN_3	qi i_l nn_l
QIN_4	qi i_h nn_l
QIN_5	qi i_m nn_m
QING_1	qi el_h ng_h
QING_2	qi el_l ng_h
QING_3	qi el_l ng_l
QING_4	qi el_h ng_l
QING_5	qi el_m ng_m
QIONG_1	qv u_h ng_h
QIONG_2	qv u_l ng_h
QIONG_3	qv u_l ng_l
QIONG_4	qv u_h ng_l
QIONG_5	qv u_m ng_m
QIU_1	qi o_h u_h
QIU_2	qi o_l u_h
QIU_3	qi o_l u_l
QIU_4	qi o_h u_l
QIU_5	qi o_m u_m
QV_1	qv v_h v_h
QV_2	qv v_l v_h
QV_3	qv v_l v_l
QV_4	qv v_h v_l
QV_5	qv v_m v_m
QVAN_1	qv a_h nn_h
QVAN_2	qv a_l nn_h
QVAN_3	qv a_l nn_l
QVAN_4	qv a_h nn_l
QVAN_5	qv a_m nn_m
QVE_1	qv eh_h eh_h
QVE_2	qv eh_l eh_h
QVE_3	qv eh_l eh_l
QVE_4	qv eh_h eh_l
QVE_5	qv eh_m eh_m
QVN_1	qv el_h nn_h
QVN_2	qv el_l nn_h
QVN_3	qv el_l nn_l
QVN_4	qv el_h nn_l
QVN_5	qv el_m nn_m
RAN_1	r a_h nn_h
RAN_2	r a_l nn_h
RAN_3	r a_l nn_l
RAN_4	r a_h nn_l
RAN_5	r a_m nn_m
RANG_1	r aa_h ng_h
RANG_2	r aa_l ng_h
RANG_3	r aa_l ng_l
RANG_4	r aa_h ng_l
RANG_5	r aa_m ng_m
RAO_1	r aa_h o_h
RAO_2	r aa_l o_h
RAO_3	r aa_l o_l
RAO_4	r aa_h o_l
RAO_5	r aa_m o_m
RE_1	r el_h el_h
RE_2	r el_l el_h
RE_3	r el_l el_l
RE_4	r el_h el_l
RE_5	r el_m el_m
REN_1	r el_h nn_h
REN_2	r el_l nn_h
REN_3	r el_l nn_l
REN_4	r el_h nn_l
REN_5	r el_m nn_m
RENG_1	r el_h ng_h
RENG_2	r el_l ng_h
RENG_3	r el_l ng_l
RENG_4	r el_h ng_l
RENG_5	r el_m ng_m
RI_1	r ib_h ib_h
RI_2	r ib_l ib_h
RI_3	r ib_l ib_l
RI_4	r ib_h ib_l
RI_5	r ib_m ib_m
RONG_1	ru u_h ng_h
RONG_2	ru u_l ng_h
RONG_3	ru u_l ng_l
RONG_4	ru u_h ng_l
RONG_5	ru u_m ng_m
ROU_1	r o_h u_h
ROU_2	r o_l u_h
ROU_3	r o_l u_l
ROU_4	r o_h u_l
ROU_5	r o_m u_m
RU_1	ru u_h u_h
RU_2	ru u_l u_h
RU_3	ru u_l u_l
RU_4	ru u_h u_l
RU_5	ru u_m u_m
RUAN_1	ru a_h nn_h
RUAN_2	ru a_l nn_h
RUAN_3	ru a_l nn_l
RUAN_4	ru a_h nn_l
RUAN_5	ru a_m nn_m
RUI_1	ru eh_h i_h
RUI_2	ru eh_l i_h
RUI_3	ru eh_l i_l
RUI_4	ru eh_h i_l
RUI_5	ru eh_m i_m
RUN_1	ru el_h nn_h
RUN_2	ru el_l nn_h
RUN_3	ru el_l nn_l
RUN_4	ru el_h nn_l
RUN_5	ru el_m nn_m
RUO_1	ru o_h o_h
RUO_2	ru o_l o_h
RUO_3	ru o_l o_l
RUO_4	ru o_h o_l
RUO_5	ru o_m o_m
SA_1	s a_h a_h
SA_2	s a_l a_h
SA_3	s a_l a_l
SA_4	s a_h a_l
SA_5	s a_m a_m
SAI_1	s a_h eh_h
SAI_2	s a_l eh_h
SAI_3	s a_l eh_l
SAI_4	s a_h eh_l
SAI_5	s a_m eh_m
SAN_1	s a_h nn_h
SAN_2	s a_l nn_h
SAN_3	s a_l nn_l
SAN_4	s a_h nn_l
SAN_5	s a_m nn_m
SANG_1	s aa_h ng_h
SANG_2	s aa_l ng_h
SANG_3	s aa_l ng_l
SANG_4	s aa_h ng_l
SANG_5	s aa_m ng_m
SAO_1	s aa_h o_h
SAO_2	s aa_l o_h
SAO_3	s aa_l o_l
SAO_4	s aa_h o_l
SAO_5	s aa_m o_m
SE_1	s el_h el_h
SE_2	s el_l el_h
SE_3	s el_l el_l
SE_4	s el_h el_l
SE_5	s el_m el_m
SEN_1	s el_h nn_h
SEN_2	s el_l nn_h
SEN_3	s el_l nn_l
SEN_4	s el_h nn_l
SEN_5	s el_m nn_m
SENG_1	s el_h ng_h
SENG_2	s el_l ng_h
SENG_3	s el_l ng_l
SENG_4	s el_h ng_l
SENG_5	s el_m ng_m
SHA_1	sh a_h a_h
SHA_2	sh a_l a_h
SHA_3	sh a_l a_l
SHA_4	sh a_h a_l
SHA_5	sh a_m a_m
SHAI_1	sh a_h eh_h
SHAI_2	sh a_l eh_h
SHAI_3	sh a_l eh_l
SHAI_4	sh a_h eh_l
SHAI_5	sh a_m eh_m
SHAN_1	sh a_h nn_h
SHAN_2	sh a_l nn_h
SHAN_3	sh a_l nn_l
SHAN_4	sh a_h nn_l
SHAN_5	sh a_m nn_m
SHANG_1	sh aa_h ng_h
SHANG_2	sh aa_l ng_h
SHANG_3	sh aa_l ng_l
SHANG_4	sh aa_h ng_l
SHANG_5	sh aa_m ng_m
SHAO_1	sh aa_h o_h
SHAO_2	sh aa_l o_h
SHAO_3	sh aa_l o_l
SHAO_4	sh aa_h o_l
SHAO_5	sh aa_m o_m
SHE_1	sh el_h el_h
SHE_2	sh el_l el_h
SHE_3	sh el_l el_l
SHE_4	sh el_h el_l
SHE_5	sh el_m el_m
SHEI_1	sh eh_h i_h
SHEI_2	sh eh_l i_h
SHEI_3	sh eh_l i_l
SHEI_4	sh eh_h i_l
SHEI_5	sh eh_m i_m
SHEN_1	sh el_h nn_h
SHEN_2	sh el_l nn_h
SHEN_3	sh el_l nn_l
SHEN_4	sh el_h nn_l
SHEN_5	sh el_m nn_m
SHENG_1	sh el_h ng_h
SHENG_2	sh el_l ng_h
SHENG_3	sh el_l ng_l
SHENG_4	sh el_h ng_l
SHENG_5	sh el_m ng_m
SHI_1	sh ib_h ib_h
SHI_2	sh ib_l ib_h
SHI_3	sh ib_l ib_l
SHI_4	sh ib_h ib_l
SHI_5	sh ib_m ib_m
SHOU_1	sh o_h u_h
SHOU_2	sh o_l u_h
SHOU_3	sh o_l u_l
SHOU_4	sh o_h u_l
SHOU_5	sh o_m u_m
SHU_1	shu u_h u_h
SHU_2	shu u_l u_h
SHU_3	shu u_l u_l
SHU_4	shu u_h u_l
SHU_5	shu u_m u_m
SHUA_1	shu a_h a_h
SHUA_2	shu a_l a_h
SHUA_3	shu a_l a_l
SHUA_4	shu a_h a_l
SHUA_5	shu a_m a_m
SHUAI_1	shu a_h eh_h
SHUAI_2	shu a_l eh_h
SHUAI_3	shu a_l eh_l
SHUAI_4	shu a_h eh_l
SHUAI_5	shu a_m eh_m
SHUAN_1	shu a_h nn_h
SHUAN_2	shu a_l nn_h
SHUAN_3	shu a_l nn_l
SHUAN_4	shu a_h nn_l
SHUAN_5	shu a_m nn_m
SHUANG_1	shu aa_h ng_h
SHUANG_2	shu aa_l ng_h
SHUANG_3	shu aa_l ng_l
SHUANG_4	shu aa_h ng_l
SHUANG_5	shu aa_m ng_m
SHUI_1	shu eh_h i_h
SHUI_2	shu eh_l i_h
SHUI_3	shu eh_l i_l
SHUI_4	shu eh_h i_l
SHUI_5	shu eh_m i_m
SHUN_1	shu el_h nn_h
SHUN_2	shu el_l nn_h
SHUN_3	shu el_l nn_l
SHUN_4	shu el_h nn_l
SHUN_5	shu el_m nn_m
SHUO_1	shu o_h o_h
SHUO_2	shu o_l o_h
SHUO_3	shu o_l o_l
SHUO_4	shu o_h o_l
SHUO_5	shu o_m o_m
SI_1	s if_h if_h
SI_2	s if_l if_h
SI_3	s if_l if_l
SI_4	s if_h if_l
SI_5	s if_m if_m
SONG_1	su u_h ng_h
SONG_2	su u_l ng_h
SONG_3	su u_l ng_l
SONG_4	su u_h ng_l
SONG_5	su u_m ng_m
SOU_1	s o_h u_h
SOU_2	s o_l u_h
SOU_3	s o_l u_l
SOU_4	s o_h u_l
SOU_5	s o_m u_m
SU_1	su u_h u_h
SU_2	su u_l u_h
SU_3	su u_l u_l
SU_4	su u_h u_l
SU_5	su u_m u_m
SUAN_1	su a_h nn_h
SUAN_2	su a_l nn_h
SUAN_3	su a_l nn_l
SUAN_4	su a_h nn_l
SUAN_5	su a_m nn_m
SUI_1	su eh_h i_h
SUI_2	su eh_l i_h
SUI_3	su eh_l i_l
SUI_4	su eh_h i_l
SUI_5	su eh_m i_m
SUN_1	su el_h nn_h
SUN_2	su el_l nn_h
SUN_3	su el_l nn_l
SUN_4	su el_h nn_l
SUN_5	su el_m nn_m
SUO_1	su o_h o_h
SUO_2	su o_l o_h
SUO_3	su o_l o_l
SUO_4	su o_h o_l
SUO_5	su o_m o_m
TA_1	t a_h a_h
TA_2	t a_l a_h
TA_3	t a_l a_l
TA_4	t a_h a_l
TA_5	t a_m a_m
TAI_1	t a_h eh_h
TAI_2	t a_l eh_h
TAI_3	t a_l eh_l
TAI_4	t a_h eh_l
TAI_5	t a_m eh_m
TAN_1	t a_h nn_h
TAN_2	t a_l nn_h
TAN_3	t a_l nn_l
TAN_4	t a_h nn_l
TAN_5	t a_m nn_m
TANG_1	t aa_h ng_h
TANG_2	t aa_l ng_h
TANG_3	t aa_l ng_l
TANG_4	t aa_h ng_l
TANG_5	t aa_m ng_m
TAO_1	t aa_h o_h
TAO_2	t aa_l o_h
TAO_3	t aa_l o_l
TAO_4	t aa_h o_l
TAO_5	t aa_m o_m
TE_1	t el_h el_h
TE_2	t el_l el_h
TE_3	t el_l el_l
TE_4	t el_h el_l
TE_5	t el_m el_m
TEI_1	t eh_h i_h
TEI_2	t eh_l i_h
TEI_3	t eh_l i_l
TEI_4	t eh_h i_l
TEI_5	t eh_m i_m
TENG_1	t el_h ng_h
TENG_2	t el_l ng_h
TENG_3	t el_l ng_l
TENG_4	t el_h ng_l
TENG_5	t el_m ng_m
TI_1	ti i_h i_h
TI_2	ti i_l i_h
TI_3	ti i_l i_l
TI_4	ti i_h i_l
TI_5	ti i_m i_m
TIAN_1	ti a_h nn_h
TIAN_2	ti a_l nn_h
TIAN_3	ti a_l nn_l
TIAN_4	ti a_h nn_l
TIAN_5	ti a_m nn_m
TIAO_1	ti aa_h o_h
TIAO_2	ti aa_l o_h
TIAO_3	ti aa_l o_l
TIAO_4	ti aa_h o_l
TIAO_5	ti aa_m o_m
TIE_1	ti eh_h eh_h
TIE_2	ti eh_l eh_h
TIE_3	ti eh_l eh_l
TIE_4	ti eh_h eh_l
TIE_5	ti eh_m eh_m
TING_1	ti el_h ng_h
TING_2	ti el_l ng_h
TING_3	ti el_l ng_l
TING_4	ti el_h ng_l
TING_5	ti el_m ng_m
TONG_1	tu u_h ng_h
TONG_2	tu u_l ng_h
TONG_3	tu u_l ng_l
TONG_4	tu u_h ng_l
TONG_5	tu u_m ng_m
TOU_1	t o_h u_h
TOU_2	t o_l u_h
TOU_3	t o_l u_l
TOU_4	t o_h u_l
TOU_5	t o_m u_m
TU_1	tu u_h u_h
TU_2	tu u_l u_h
TU_3	tu u_l u_l
TU_4	tu u_h u_l
TU_5	tu u_m u_m
TUAN_1	tu a_h nn_h
TUAN_2	tu a_l nn_h
TUAN_3	tu a_l nn_l
TUAN_4	tu a_h nn_l
TUAN_5	tu a_m nn_m
TUI_1	tu eh_h i_h
TUI_2	tu eh_l i_h
TUI_3	tu eh_l i_l
TUI_4	tu eh_h i_l
TUI_5	tu eh_m i_m
TUN_1	tu el_h nn_h
TUN_2	tu el_l nn_h
TUN_3	tu el_l nn_l
TUN_4	tu el_h nn_l
TUN_5	tu el_m nn_m
TUO_1	tu o_h o_h
TUO_2	tu o_l o_h
TUO_3	tu o_l o_l
TUO_4	tu o_h o_l
TUO_5	tu o_m o_m
WA_1	wu a_h a_h
WA_2	wu a_l a_h
WA_3	wu a_l a_l
WA_4	wu a_h a_l
WA_5	wu a_m a_m
WAI_1	wu a_h eh_h
WAI_2	wu a_l eh_h
WAI_3	wu a_l eh_l
WAI_4	wu a_h eh_l
WAI_5	wu a_m eh_m
WAN_1	wu a_h nn_h
WAN_2	wu a_l nn_h
WAN_3	wu a_l nn_l
WAN_4	wu a_h nn_l
WAN_5	wu a_m nn_m
WANG_1	wu aa_h ng_h
WANG_2	wu aa_l ng_h
WANG_3	wu aa_l ng_l
WANG_4	wu aa_h ng_l
WANG_5	wu aa_m ng_m
WEI_1	wu eh_h i_h
WEI_2	wu eh_l i_h
WEI_3	wu eh_l i_l
WEI_4	wu eh_h i_l
WEI_5	wu eh_m i_m
WEN_1	wu el_h nn_h
WEN_2	wu el_l nn_h
WEN_3	wu el_l nn_l
WEN_4	wu el_h nn_l
WEN_5	wu el_m nn_m
WENG_1	wu el_h ng_h
WENG_2	wu el_l ng_h
WENG_3	wu el_l ng_l
WENG_4	wu el_h ng_l
WENG_5	wu el_m ng_m
WO_1	wu o_h o_h
WO_2	wu o_l o_h
WO_3	wu o_l o_l
WO_4	wu o_h o_l
WO_5	wu o_m o_m
WU_1	wu u_h u_h
WU_2	wu u_l u_h
WU_3	wu u_l u_l
WU_4	wu u_h u_l
WU_5	wu u_m u_m
XI_1	xi i_h i_h
XI_2	xi i_l i_h
XI_3	xi i_l i_l
XI_4	xi i_h i_l
XI_5	xi i_m i_m
XIA_1	xi a_h a_h
XIA_2	xi a_l a_h
XIA_3	xi a_l a_l
XIA_4	xi a_h a_l
XIA_5	xi a_m a_m
XIAN_1	xi a_h nn_h
XIAN_2	xi a_l nn_h
XIAN_3	xi a_l nn_l
XIAN_4	xi a_h nn_l
XIAN_5	xi a_m nn_m
XIANG_1	xi aa_h ng_h
XIANG_2	xi aa_l ng_h
XIANG_3	xi aa_l ng_l
XIANG_4	xi aa_h ng_l
XIANG_5	xi aa_m ng_m
XIAO_1	xi aa_h o_h
XIAO_2	xi aa_l o_h
XIAO_3	xi aa_l o_l
XIAO_4	xi aa_h o_l
XIAO_5	xi aa_m o_m
XIE_1	xi eh_h eh_h
XIE_2	xi eh_l eh_h
XIE_3	xi eh_l eh_l
XIE_4	xi eh_h eh_l
XIE_5	xi eh_m eh_m
XIN_1	xi i_h nn_h
XIN_2	xi i_l nn_h
XIN_3	xi i_l nn_l
XIN_4	xi i_h nn_l
XIN_5	xi i_m nn_m
XING_1	xi el_h ng_h
XING_2	xi el_l ng_h
XING_3	xi el_l ng_l
XING_4	xi el_h ng_l
XING_5	xi el_m ng_m
XIONG_1	xv u_h ng_h
XIONG_2	xv u_l ng_h
XIONG_3	xv u_l ng_l
XIONG_4	xv u_h ng_l
XIONG_5	xv u_m ng_m
XIU_1	xi o_h u_h
XIU_2	xi o_l u_h
XIU_3	xi o_l u_l
XIU_4	xi o_h u_l
XIU_5	xi o_m u_m
XV_1	xv v_h v_h
XV_2	xv v_l v_h
XV_3	xv v_l v_l
XV_4	xv v_h v_l
XV_5	xv v_m v_m
XVAN_1	xv a_h nn_h
XVAN_2	xv a_l nn_h
XVAN_3	xv a_l nn_l
XVAN_4	xv a_h nn_l
XVAN_5	xv a_m nn_m
XVE_1	xv eh_h eh_h
XVE_2	xv eh_l eh_h
XVE_3	xv eh_l eh_l
XVE_4	xv eh_h eh_l
XVE_5	xv eh_m eh_m
XVN_1	xv el_h nn_h
XVN_2	xv el_l nn_h
XVN_3	xv el_l nn_l
XVN_4	xv el_h nn_l
XVN_5	xv el_m nn_m
YA_1	yi a_h a_h
YA_2	yi a_l a_h
YA_3	yi a_l a_l
YA_4	yi a_h a_l
YA_5	yi a_m a_m
YAN_1	yi a_h nn_h
YAN_2	yi a_l nn_h
YAN_3	yi a_l nn_l
YAN_4	yi a_h nn_l
YAN_5	yi a_m nn_m
YANG_1	yi aa_h ng_h
YANG_2	yi aa_l ng_h
YANG_3	yi aa_l ng_l
YANG_4	yi aa_h ng_l
YANG_5	yi aa_m ng_m
YAO_1	yi aa_h o_h
YAO_2	yi aa_l o_h
YAO_3	yi aa_l o_l
YAO_4	yi aa_h o_l
YAO_5	yi aa_m o_m
YE_1	yi eh_h eh_h
YE_2	yi eh_l eh_h
YE_3	yi eh_l eh_l
YE_4	yi eh_h eh_l
YE_5	yi eh_m eh_m
YI_1	yi i_h i_h
YI_2	yi i_l i_h
YI_3	yi i_l i_l
YI_4	yi i_h i_l
YI_5	yi i_m i_m
YIN_1	yi i_h nn_h
YIN_2	yi i_l nn_h
YIN_3	yi i_l nn_l
YIN_4	yi i_h nn_l
YIN_5	yi i_m nn_m
YING_1	yi el_h ng_h
YING_2	yi el_l ng_h
YING_3	yi el_l ng_l
YING_4	yi el_h ng_l
YING_5	yi el_m ng_m
YO_1	yi o_h o_h
YO_2	yi o_l o_h
YO_3	yi o_l o_l
YO_4	yi o_h o_l
YO_5	yi o_m o_m
YONG_1	yi u_h ng_h
YONG_2	yi u_l ng_h
YONG_3	yi u_l ng_l
YONG_4	yi u_h ng_l
YONG_5	yi u_m ng_m
YOU_1	yi o_h u_h
YOU_2	yi o_l u_h
YOU_3	yi o_l u_l
YOU_4	yi o_h u_l
YOU_5	yi o_m u_m
YV_1	yv v_h v_h
YV_2	yv v_l v_h
YV_3	yv v_l v_l
YV_4	yv v_h v_l
YV_5	yv v_m v_m
YVAN_1	yv a_h nn_h
YVAN_2	yv a_l nn_h
YVAN_3	yv a_l nn_l
YVAN_4	yv a_h nn_l
YVAN_5	yv a_m nn_m
YVE_1	yv eh_h eh_h
YVE_2	yv eh_l eh_h
YVE_3	yv eh_l eh_l
YVE_4	yv eh_h eh_l
YVE_5	yv eh_m eh_m
YVN_1	yv el_h nn_h
YVN_2	yv el_l nn_h
YVN_3	yv el_l nn_l
YVN_4	yv el_h nn_l
YVN_5	yv el_m nn_m
ZA_1	z a_h a_h
ZA_2	z a_l a_h
ZA_3	z a_l a_l
ZA_4	z a_h a_l
ZA_5	z a_m a_m
ZAI_1	z a_h eh_h
ZAI_2	z a_l eh_h
ZAI_3	z a_l eh_l
ZAI_4	z a_h eh_l
ZAI_5	z a_m eh_m
ZAN_1	z a_h nn_h
ZAN_2	z a_l nn_h
ZAN_3	z a_l nn_l
ZAN_4	z a_h nn_l
ZAN_5	z a_m nn_m
ZANG_1	z aa_h ng_h
ZANG_2	z aa_l ng_h
ZANG_3	z aa_l ng_l
ZANG_4	z aa_h ng_l
ZANG_5	z aa_m ng_m
ZAO_1	z aa_h o_h
ZAO_2	z aa_l o_h
ZAO_3	z aa_l o_l
ZAO_4	z aa_h o_l
ZAO_5	z aa_m o_m
ZE_1	z el_h el_h
ZE_2	z el_l el_h
ZE_3	z el_l el_l
ZE_4	z el_h el_l
ZE_5	z el_m el_m
ZEI_1	z eh_h i_h
ZEI_2	z eh_l i_h
ZEI_3	z eh_l i_l
ZEI_4	z eh_h i_l
ZEI_5	z eh_m i_m
ZEN_1	z el_h nn_h
ZEN_2	z el_l nn_h
ZEN_3	z el_l nn_l
ZEN_4	z el_h nn_l
ZEN_5	z el_m nn_m
ZENG_1	z el_h ng_h
ZENG_2	z el_l ng_h
ZENG_3	z el_l ng_l
ZENG_4	z el_h ng_l
ZENG_5	z el_m ng_m
ZHA_1	zh a_h a_h
ZHA_2	zh a_l a_h
ZHA_3	zh a_l a_l
ZHA_4	zh a_h a_l
ZHA_5	zh a_m a_m
ZHAI_1	zh a_h eh_h
ZHAI_2	zh a_l eh_h
ZHAI_3	zh a_l eh_l
ZHAI_4	zh a_h eh_l
ZHAI_5	zh a_m eh_m
ZHAN_1	zh a_h nn_h
ZHAN_2	zh a_l nn_h
ZHAN_3	zh a_l nn_l
ZHAN_4	zh a_h nn_l
ZHAN_5	zh a_m nn_m
ZHANG_1	zh aa_h ng_h
ZHANG_2	zh aa_l ng_h
ZHANG_3	zh aa_l ng_l
ZHANG_4	zh aa_h ng_l
ZHANG_5	zh aa_m ng_m
ZHAO_1	zh aa_h o_h
ZHAO_2	zh aa_l o_h
ZHAO_3	zh aa_l o_l
ZHAO_4	zh aa_h o_l
ZHAO_5	zh aa_m o_m
ZHE_1	zh el_h el_h
ZHE_2	zh el_l el_h
ZHE_3	zh el_l el_l
ZHE_4	zh el_h el_l
ZHE_5	zh el_m el_m
ZHEI_1	zh eh_h i_h
ZHEI_2	zh eh_l i_h
ZHEI_3	zh eh_l i_l
ZHEI_4	zh eh_h i_l
ZHEI_5	zh eh_m i_m
ZHEN_1	zh el_h nn_h
ZHEN_2	zh el_l nn_h
ZHEN_3	zh el_l nn_l
ZHEN_4	zh el_h nn_l
ZHEN_5	zh el_m nn_m
ZHENG_1	zh el_h ng_h
ZHENG_2	zh el_l ng_h
ZHENG_3	zh el_l ng_l
ZHENG_4	zh el_h ng_l
ZHENG_5	zh el_m ng_m
ZHI_1	zh ib_h ib_h
ZHI_2	zh ib_l ib_h
ZHI_3	zh ib_l ib_l
ZHI_4	zh ib_h ib_l
ZHI_5	zh ib_m ib_m
ZHONG_1	zhu u_h ng_h
ZHONG_2	zhu u_l ng_h
ZHONG_3	zhu u_l ng_l
ZHONG_4	zhu u_h ng_l
ZHONG_5	zhu u_m ng_m
ZHOU_1	zh o_h u_h
ZHOU_2	zh o_l u_h
ZHOU_3	zh o_l u_l
ZHOU_4	zh o_h u_l
ZHOU_5	zh o_m u_m
ZHU_1	zhu u_h u_h
ZHU_2	zhu u_l u_h
ZHU_3	zhu u_l u_l
ZHU_4	zhu u_h u_l
ZHU_5	zhu u_m u_m
ZHUA_1	zhu a_h a_h
ZHUA_2	zhu a_l a_h
ZHUA_3	zhu a_l a_l
ZHUA_4	zhu a_h a_l
ZHUA_5	zhu a_m a_m
ZHUAI_1	zhu a_h eh_h
ZHUAI_2	zhu a_l eh_h
ZHUAI_3	zhu a_l eh_l
ZHUAI_4	zhu a_h eh_l
ZHUAI_5	zhu a_m eh_m
ZHUAN_1	zhu a_h nn_h
ZHUAN_2	zhu a_l nn_h
ZHUAN_3	zhu a_l nn_l
ZHUAN_4	zhu a_h nn_l
ZHUAN_5	zhu a_m nn_m
ZHUANG_1	zhu aa_h ng_h
ZHUANG_2	zhu aa_l ng_h
ZHUANG_3	zhu aa_l ng_l
ZHUANG_4	zhu aa_h ng_l
ZHUANG_5	zhu aa_m ng_m
ZHUI_1	zhu eh_h i_h
ZHUI_2	zhu eh_l i_h
ZHUI_3	zhu eh_l i_l
ZHUI_4	zhu eh_h i_l
ZHUI_5	zhu eh_m i_m
ZHUN_1	zhu el_h nn_h
ZHUN_2	zhu el_l nn_h
ZHUN_3	zhu el_l nn_l
ZHUN_4	zhu el_h nn_l
ZHUN_5	zhu el_m nn_m
ZHUO_1	zhu o_h o_h
ZHUO_2	zhu o_l o_h
ZHUO_3	zhu o_l o_l
ZHUO_4	zhu o_h o_l
ZHUO_5	zhu o_m o_m
ZI_1	z if_h if_h
ZI_2	z if_l if_h
ZI_3	z if_l if_l
ZI_4	z if_h if_l
ZI_5	z if_m if_m
ZONG_1	zu u_h ng_h
ZONG_2	zu u_l ng_h
ZONG_3	zu u_l ng_l
ZONG_4	zu u_h ng_l
ZONG_5	zu u_m ng_m
ZOU_1	z o_h u_h
ZOU_2	z o_l u_h
ZOU_3	z o_l u_l
ZOU_4	z o_h u_l
ZOU_5	z o_m u_m
ZU_1	zu u_h u_h
ZU_2	zu u_l u_h
ZU_3	zu u_l u_l
ZU_4	zu u_h u_l
ZU_5	zu u_m u_m
ZUAN_1	zu a_h nn_h
ZUAN_2	zu a_l nn_h
ZUAN_3	zu a_l nn_l
ZUAN_4	zu a_h nn_l
ZUAN_5	zu a_m nn_m
ZUI_1	zu eh_h i_h
ZUI_2	zu eh_l i_h
ZUI_3	zu eh_l i_l
ZUI_4	zu eh_h i_l
ZUI_5	zu eh_m i_m
ZUN_1	zu el_h nn_h
ZUN_2	zu el_l nn_h
ZUN_3	zu el_l nn_l
ZUN_4	zu el_h nn_l
ZUN_5	zu el_m nn_m
ZUO_1	zu o_h o_h
ZUO_2	zu o_l o_h
ZUO_3	zu o_l o_l
ZUO_4	zu o_h o_l
ZUO_5	zu o_m o_m
NEGSHOU	sh
NEGSHOU	sh ib_h ib_h
XXX	bu u_h u_l
XXX	b eh_h i_h
XXX	bi a_h nn_l
XXX	bi i_l i_l
XXX	c if_h if_l
XXX	c el_l ng_h
XXX	di a_l nn_l
XXX	f el_h nn_h
XXX	g el_h el_l
XXX	ji a_h nn_l
XXX	ji eh_h eh_l
XXX	k a_h nn_l
XXX	k el_h el_l
XXX	li aa_h ng_l
XXX	ku a_h eh_l
XXX	mi aa_l o_l
XXX	mu u_h u_l
XXX	pi a_h nn_l
XXX	qi eh_h eh_l
XXX	t aa_h o_h
XXX	ti aa_h o_l
XXX	ti a_h nn_h
XXX	wu a_l nn_l
XXX	wu eh_h i_l
XXX	zh ib_h ib_h
XXX	sh o_l u_l
XXX	s o_l u_l
DC_NIHAO    ji a_h a_h
DC_NIHAO    wu o_l o_l
DC_NIHAO    sil sil sil sil sil
DC_BAN  b a_h nn_h
DC_BAN  b a_h a_l
DC_MA   a_h a_h
DC_MA   m a_h a_h
DC_MA   m a_m a_m
DC_MA   b a_h a_h
DC_MA   b a_m a_m
DC_DAO	sh o_h u_h
DC_HANG	c aa_l ng_h
DC_FANG	g aa_h o_h
DC_DA	d el_l el_h
一	yi aa_h o_h
一	yi i_h i_h
一	yi i_h i_l
一	yi i_l i_h
一	yi i_m i_m
1	yi aa_h o_h
1	yi i_h i_h
1	yi i_h i_l
1	yi i_l i_h
1	yi i_m i_m
丁	di el_h ng_h
丁	di el_m ng_m
丁	zh el_h ng_h
七	qi i_h i_h
7	qi i_h i_h
万	mu o_h o_l
万	wu a_h nn_l
丈	zh aa_h ng_l
三	s a_h nn_h
3	s a_h nn_h
上	sh aa_h ng_l
上	sh aa_l ng_l
上	sh aa_m ng_m
下	xi a_h a_l
下	xi a_m a_m
丌	ji i_h i_h
丌	qi i_l i_h
不	bu u_h u_l
不	bu u_l u_h
不	bu u_m u_m
与	yv v_h v_l
与	yv v_l v_h
与	yv v_l v_l
丐	g a_h eh_l
丑	ch o_l u_l
专	zhu a_h nn_h
且	jv v_h v_h
且	qi eh_l eh_l
丕	pi i_h i_h
世	sh ib_h ib_l
丘	qi o_h u_h
丙	bi el_l ng_l
业	yi eh_h eh_l
丛	cu u_l ng_h
东	du u_h ng_h
丝	s if_h if_h
丞	ch el_l ng_h
丢	di o_h u_h
两	li aa_l ng_l
严	yi a_l nn_h
严	yi a_l nn_l
丧	s aa_h ng_h
丧	s aa_h ng_l
丨	gu el_l nn_l
丨	shu u_h u_l
个	g el_h el_l
个	g el_l el_l
个	g el_m el_m
丫	yi a_h a_h
中	zhu u_h ng_h
中	zhu u_h ng_l
丰	f el_h ng_h
串	chu a_h nn_l
临	li i_l nn_h
丶	di a_l nn_l
丶	zhu u_l u_l
丸	wu a_l nn_h
丹	d a_h nn_h
为	wu eh_h i_l
为	wu eh_l i_h
为	wu eh_m i_m
主	zhu u_l u_l
丽	li i_h i_l
丽	li i_l i_h
举	jv v_l v_l
举	jv v_m v_m
丿	pi eh_l eh_l
乃	n a_l eh_l
久	ji o_l u_l
乇	tu o_h o_h
么	m a_m a_m
么	m el_m el_m
么	mu o_l o_l
么	yi aa_h o_h
义	yi i_h i_l
义	yi i_l i_h
之	zh ib_h ib_h
乌	wu u_h u_h
乌	wu u_h u_l
乍	zh a_h a_l
乎	hu u_h u_h
乎	hu u_m u_m
乏	f a_l a_h
乐	l el_h el_l
乐	yv eh_h eh_l
乒	pi el_h ng_h
乓	p aa_h ng_h
乔	qi aa_l o_h
乖	gu a_h eh_h
乘	ch el_l ng_h
乘	sh el_h ng_l
乙	yi i_l i_l
乜	mi eh_h eh_h
乜	ni eh_h eh_l
九	ji o_l u_h
九	ji o_l u_l
9	ji o_l u_h
9	ji o_l u_l
乞	qi i_l i_l
乞	qi i_m i_m
也	yi eh_l eh_l
习	xi i_l i_h
乡	xi aa_h ng_h
乡	xi aa_h ng_l
书	shu u_h u_h
买	m a_l eh_l
乱	lu a_h nn_l
乳	ru u_l u_l
乾	g a_h nn_h
乾	qi a_l nn_h
了	l el_m el_m
了	li aa_l o_l
予	yv v_l v_h
予	yv v_l v_l
争	zh el_h ng_h
争	zh el_h ng_l
事	sh ib_h ib_l
事	sh ib_m ib_m
二	er_h er_l
2	er_h er_l
亍	chu u_h u_l
于	yv v_l v_h
亏	ku eh_h i_h
云	yv el_l nn_h
互	hu u_h u_l
亓	qi i_l i_h
五	wu u_l u_h
五	wu u_l u_l
5	wu u_l u_h
5	wu u_l u_l
井	ji el_l ng_l
亘	g el_h nn_l
亚	yi a_h a_l
些	xi eh_h eh_h
亡	wu aa_l ng_h
亡	wu u_l u_h
亢	k aa_h ng_l
交	ji aa_h o_h
亥	h a_h eh_l
亦	yi i_h i_l
产	ch a_l nn_l
亨	h el_h ng_h
亩	mu u_l u_l
享	xi aa_l ng_l
京	ji el_h ng_h
亭	ti el_l ng_h
亮	li aa_h ng_l
亮	li aa_m ng_m
亲	qi el_h ng_l
亲	qi i_h nn_h
亳	bu o_l o_h
人	r el_l nn_h
人	r el_m nn_m
亿	yi i_h i_l
什	sh el_l nn_h
什	sh ib_l ib_h
什	sh ib_m ib_m
仁	r el_l nn_h
仂	l el_h el_l
仃	di el_h ng_h
仄	z el_h el_l
仅	ji i_h nn_l
仅	ji i_l nn_l
仆	pu u_h u_h
仆	pu u_l u_h
仇	ch o_l u_h
仇	qi o_l u_h
仉	zh aa_l ng_l
今	ji i_h nn_h
介	ji eh_h eh_l
仍	r el_l ng_h
从	cu u_h ng_h
从	cu u_l ng_h
仑	lu el_l nn_h
仓	c aa_h ng_h
仔	z a_l eh_l
仔	z if_h if_h
仔	z if_l if_l
仕	sh ib_h ib_l
他	t a_h a_h
仗	zh aa_h ng_l
仗	zh aa_m ng_m
付	fu u_h u_l
仙	xi a_h nn_h
仝	tu u_l ng_h
仞	r el_h nn_l
仟	qi a_h nn_h
仡	g el_h el_h
仡	yi i_h i_l
代	d a_h eh_l
令	li el_h ng_l
令	li el_l ng_h
令	li el_l ng_l
以	yi i_l i_l
仨	s a_h a_h
仨	s a_h nn_h
仪	yi i_l i_h
仫	mu u_h u_l
们	m el_l nn_h
们	m el_m nn_m
仰	yi aa_l ng_l
仲	zhu u_h ng_l
仵	wu u_l u_l
件	ji a_h nn_l
价	ji a_h a_l
价	ji a_m a_m
价	ji eh_h eh_l
价	ji eh_m eh_m
任	r el_h nn_l
任	r el_l nn_h
份	f el_h nn_l
仿	f aa_l ng_l
企	qi i_l i_l
伉	k aa_h ng_l
伊	yi i_h i_h
伍	wu u_l u_l
伎	ji i_h i_l
伏	fu u_l u_h
伐	f a_l a_h
休	xi o_h u_h
众	zhu u_h ng_l
优	yi o_h u_h
伙	hu o_l o_l
伙	hu o_m o_m
会	hu eh_h i_l
会计	ku a_h eh_l ji i_h i_l
会计	ku a_h eh_l ji i_m i_m
会稽	ku a_h eh_l ji i_h i_h
伞	s a_l nn_l
伟	wu eh_l i_l
传	chu a_l nn_h
传	zhu a_h nn_l
伢	yi a_l a_h
伤	sh aa_h ng_h
伥	ch aa_h ng_h
伦	lu el_l nn_h
伧	c aa_h ng_h
伧	ch el_m nn_m
伪	wu eh_l i_l
伫	zhu u_h u_l
伯	b a_h eh_h
伯	b a_l eh_l
伯	b a_m eh_m
伯	bu o_l o_h
伯	bu o_m o_m
估	gu u_h u_h
估	gu u_h u_l
伲	ni i_h i_l
伲	ni i_l i_l
伴	b a_h nn_l
伶	li el_l ng_h
伸	sh el_h nn_h
伺	c if_h if_l
伺	s if_h if_l
似	sh ib_h ib_l
似	s if_h if_l
伽	g a_h a_h
伽	ji a_h a_h
伽	qi eh_l eh_h
佃	di a_h nn_l
佃	ti a_l nn_h
但	d a_h nn_l
位	wu eh_h i_l
低	di i_h i_h
住	zhu u_h u_l
佐	zu o_l o_l
佑	yi o_h u_l
体	ti i_h i_h
体	ti i_l i_l
何	h el_h el_l
何	h el_l el_h
佗	tu o_l o_h
佘	sh el_l el_h
余	yv v_l v_h
佚	yi i_h i_l
佛	fu o_l o_h
佛	fu u_l u_h
作	zu o_h o_h
作	zu o_h o_l
作	zu o_l o_h
作	zu o_m o_m
佟	tu u_l ng_h
你	ni i_l i_l
佣	yi u_h ng_h
佣	yi u_h ng_l
佤	wu a_l a_l
佥	qi a_h nn_h
佧	k a_l a_l
佩	p eh_h i_l
佬	l aa_l o_l
佯	yi aa_l ng_h
佰	b a_l eh_l
佳	ji a_h a_h
佴	er_h er_l
佴	n a_h eh_l
佶	ji i_l i_h
佼	ji aa_l o_l
佾	yi i_h i_l
使	sh ib_l ib_l
使	sh ib_m ib_m
侃	k a_l nn_l
侄	zh ib_l ib_h
侈	ch ib_l ib_l
侉	ku a_l a_l
例	li i_h i_l
侍	sh ib_h ib_l
侏	zhu u_h u_h
侑	yi o_h u_l
侗	du u_h ng_l
侗	tu u_l ng_h
侗	tu u_l ng_l
供	gu u_h ng_h
供	gu u_h ng_l
依	yi i_h i_h
侠	xi a_l a_h
侣	lv v_l v_l
侥	ji aa_l o_l
侥	yi aa_l o_h
侦	zh el_h nn_h
侧	c el_h el_l
侧	z el_h el_l
侧	zh a_h eh_h
侨	qi aa_l o_h
侩	ku a_h eh_l
侪	ch a_l eh_h
侬	nu u_l ng_h
侯	h o_h u_l
侯	h o_l u_h
侵	qi i_h nn_h
便	bi a_h nn_l
便	bi a_m nn_m
便	pi a_l nn_h
促	cu u_h u_l
俄	el_l el_h
俅	qi o_l u_h
俊	jv el_h nn_l
俎	zu u_l u_l
俏	qi aa_h o_l
俐	li i_h i_l
俑	yi u_l ng_l
俗	su u_l u_h
俘	fu u_l u_h
俚	li i_l i_l
保	b aa_l o_l
俞	shu u_h u_l
俞	yv v_l v_h
俟	qi i_l i_h
俟	s if_h if_l
信	xi i_h nn_l
俣	yv v_l v_l
俦	ch o_l u_h
俨	yi a_l nn_l
俩	li aa_l ng_l
俩	li a_l a_l
俪	li i_h i_l
俭	ji a_l nn_l
修	xi o_h u_h
俯	fu u_l u_l
俱	jv v_h v_h
俱	jv v_h v_l
俸	f el_h ng_l
俺	a_l nn_l
俾	bi i_l i_l
倌	gu a_h nn_h
倍	b eh_h i_l
倒	d aa_h o_l
倒	d aa_l o_l
倔	jv eh_h eh_l
倔	jv eh_l eh_h
倘	ch aa_l ng_h
倘	t aa_l ng_l
候	h o_h u_l
候	h o_m u_m
倚	yi i_l i_l
倜	ti i_h i_l
借	ji eh_h eh_l
倡	ch aa_h ng_l
倦	jv a_h nn_l
倨	jv v_h v_l
倩	qi a_h nn_l
倪	ni i_l i_h
倬	zhu o_h o_h
倭	wu o_h o_h
倮	lu o_l o_l
债	zh a_h eh_l
值	zh ib_l ib_h
倾	qi el_h ng_h
偃	yi a_l nn_l
假	ji a_h a_l
假	ji a_l a_l
偌	ru o_h o_l
偎	wu eh_h i_h
偏	pi a_h nn_h
偕	xi eh_l eh_h
做	zu o_h o_l
停	ti el_l ng_h
健	ji a_h nn_l
偶	o_l u_l
偷	t o_h u_h
偻	l o_l u_h
偻	lv v_l v_l
偾	f el_h nn_l
偿	ch aa_l ng_h
傀	gu eh_h i_h
傀	ku eh_l i_l
傅	fu u_h u_l
傅	fu u_m u_m
傈	li i_h i_l
傍	b aa_h ng_l
傣	d a_l eh_l
傥	t aa_l ng_l
傧	bi i_h nn_h
储	chu u_l u_l
傩	nu o_l o_h
催	cu eh_h i_h
傲	aa_h o_l
傻	sh a_l a_l
像	xi aa_h ng_l
僖	xi i_h i_h
僚	li aa_l o_h
僦	ji o_h u_l
僧	s el_h ng_h
僮	tu u_l ng_h
僮	zhu aa_h ng_l
僳	su u_h u_l
僵	ji aa_h ng_h
僻	pi i_h i_l
儆	ji el_l ng_l
儋	d a_h nn_h
儒	ru u_l u_h
儡	l eh_l i_l
儿	er_l er_h
儿	er_m er_m
兀	wu u_h u_h
兀	wu u_h u_l
允	yv el_l nn_l
元	yv a_l nn_h
兄	xv u_h ng_h
充	chu u_h ng_h
兆	zh aa_h o_l
先	xi a_h nn_h
光	gu aa_h ng_h
克	k el_h el_l
免	mi a_l nn_l
兑	du eh_h i_l
兑	du eh_m i_m
兔	tu u_h u_l
兖	yi a_l nn_l
党	d aa_l ng_l
兜	d o_h u_h
兢	ji el_h ng_h
入	ru u_h u_l
全	qv a_l nn_h
八	b a_h a_h
八	b a_l a_h
八	b a_m a_m
8	b a_h a_h
8	b a_l a_h
8	b a_m a_m
公	gu u_h ng_h
公	gu u_m ng_m
六	li o_h u_l
六安	lu u_h u_l a_h nn_h
六合	lu u_h u_l h el_l el_h
6	li o_h u_l
兮	xi i_h i_h
兰	l a_l nn_h
共	gu u_h ng_h
共	gu u_h ng_l
关	gu a_h nn_h
兴	xi el_h ng_h
兴	xi el_h ng_l
兴	xi el_m ng_m
兵	bi el_h ng_h
其	ji i_h i_h
其	qi i_l i_h
具	jv v_h v_l
典	di a_l nn_l
兹	c if_l if_h
兹	z if_h if_h
养	yi aa_l ng_l
兼	ji a_h nn_h
兽	sh o_h u_l
冀	ji i_h i_l
冁	ch a_l nn_l
冂	tu u_l ng_h
内	n eh_h i_l
冈	g aa_h ng_h
冉	r a_l nn_l
册	c el_h el_l
再	z a_h eh_l
冒	m aa_h o_l
冒	mu o_h o_l
冕	mi a_l nn_l
冗	ru u_l ng_l
写	xi eh_h eh_l
写	xi eh_l eh_l
军	jv el_h nn_h
农	nu u_l ng_h
冠	gu a_h nn_h
冠	gu a_h nn_l
冠	gu a_m nn_m
冢	zhu u_l ng_l
冤	yv a_h nn_h
冥	mi el_l ng_h
冫	bi el_h ng_h
冫	li aa_l ng_l
冬	du u_h ng_h
冯	f el_l ng_h
冯	pi el_l ng_h
冰	bi el_h ng_h
冱	hu u_h u_l
冲	chu u_h ng_h
冲	chu u_h ng_l
决	jv eh_l eh_h
况	ku aa_h ng_l
冶	yi eh_l eh_l
冷	l el_l ng_l
冻	du u_h ng_l
冼	xi a_l nn_l
冽	li eh_h eh_l
净	ji el_h ng_l
凄	qi i_h i_h
准	zhu el_l nn_l
凇	su u_h ng_h
凉	li aa_l ng_h
凋	di aa_h o_h
凌	li el_h ng_h
凌	li el_l ng_h
减	ji a_l nn_l
凑	c o_h u_l
凛	li i_l nn_l
凝	ni el_l ng_h
几	ji i_h i_h
几	ji i_l i_l
凡	f a_l nn_h
凤	f el_h ng_l
凫	fu u_l u_h
凭	pi el_l ng_h
凯	k a_l eh_l
凰	hu aa_l ng_h
凳	d el_h ng_l
凶	xv u_h ng_h
凸	tu u_h u_h
凹	aa_h o_h
凹	wu a_h a_h
出	chu u_h u_h
出	chu u_m u_m
击	ji i_h i_h
凼	d aa_h ng_l
函	h a_l nn_h
凿	z aa_l o_h
凿	zu o_h o_l
刀	d aa_h o_h
刁	di aa_h o_h
刃	r el_h nn_l
分	f el_h nn_h
分	f el_h nn_l
分	f el_m nn_m
切	qi eh_h eh_h
切	qi eh_h eh_l
刈	yi i_h i_l
刊	k a_h nn_h
刍	chu u_l u_h
刑	xi el_l ng_h
划	hu a_h a_l
划	hu a_l a_h
划	hu a_m a_m
划	hu a_m eh_m
列	li eh_h eh_l
刘	li o_l u_h
则	z el_l el_h
刚	g aa_h ng_h
创	chu aa_h ng_h
创	chu aa_h ng_l
初	chu u_h u_h
删	sh a_h nn_h
判	p a_h nn_l
刨	b aa_h o_l
刨	p aa_l o_h
利	li i_h i_l
利	li i_m i_m
别	bi eh_h eh_l
别	bi eh_l eh_h
别	bi eh_m eh_m
刮	gu a_h a_h
到	d aa_h o_l
制	zh ib_h ib_l
刷	shu a_h a_h
刷	shu a_h a_l
券	qv a_h nn_l
券	xv a_h nn_l
刹	ch a_h a_l
刹	sh a_h a_h
刺	c if_h if_h
刺	c if_h if_l
刻	k el_h el_l
刽	gu eh_h i_l
刽	ku a_h eh_l
剀	k a_l eh_l
剁	du o_h o_l
剂	ji i_h i_l
剃	ti i_h i_l
削	xi aa_h o_h
削	xv eh_h eh_h
剋	k eh_h i_h
剋	k el_h el_l
剌	l a_h a_l
剌	l a_l a_h
前	qi a_l nn_h
剐	gu a_l a_l
剑	ji a_h nn_l
剔	ti i_h i_h
剔	ti i_h i_l
剖	p aa_h o_h
剖	p o_h u_h
剡	sh a_h nn_l
剡	yi a_l nn_l
剥	b aa_h o_h
剥	bu o_h o_h
剥	pu u_h u_h
剧	jv v_h v_l
剩	sh el_h ng_l
剪	ji a_l nn_l
副	fu u_h u_l
割	g el_h el_h
剿	ch aa_h o_h
剿	ji aa_l o_l
劈	pi i_h i_h
劈	pi i_l i_l
劐	hu o_h o_h
劓	yi i_h i_l
力	li i_h i_l
劝	qv a_h nn_l
办	b a_h nn_l
功	gu u_h ng_h
加	ji a_h a_h
务	wu u_h u_l
务	wu u_m u_m
劢	m a_h eh_l
劣	li eh_h eh_l
动	du u_h ng_l
助	zhu u_h u_l
努	nu u_l u_l
劫	ji eh_l eh_h
劬	qv v_l v_h
劭	sh aa_h o_l
励	li i_h i_l
劲	ji el_h ng_l
劲	ji i_h nn_l
劳	l aa_l o_h
劵	jv a_h nn_l
势	sh ib_h ib_l
势	sh ib_m ib_m
勃	bu o_l o_h
勇	yi u_l ng_l
勉	mi a_l nn_l
勋	xv el_h nn_h
勐	m el_l ng_l
勒	l eh_h i_h
勒	l el_h el_l
勖	xv v_h v_l
勘	k a_h nn_h
募	mu u_h u_l
勤	qi i_l nn_h
勰	xi eh_l eh_h
勺	sh aa_l o_h
勾	g o_h u_h
勾	g o_h u_l
勿	wu u_h u_l
匀	yv el_l nn_h
包	b aa_h o_h
匆	cu u_h ng_h
匈	xv u_h ng_h
匍	pu u_l u_h
匏	p aa_l o_h
匕	bi i_l i_l
化	hu a_h a_h
化	hu a_h a_l
北	b eh_l i_l
匙	ch ib_l ib_h
匙	sh ib_l ib_h
匙	sh ib_m ib_m
匚	f aa_h ng_h
匚	qv v_h v_h
匝	z a_h a_h
匠	ji aa_h ng_l
匠	ji aa_m ng_m
匡	ku aa_h ng_h
匣	xi a_l a_h
匪	f eh_l i_l
匮	ku eh_h i_l
匹	pi i_l i_l
区	o_h u_h
区	qv v_h v_h
医	yi i_h i_h
匾	bi a_l nn_l
匿	ni i_h i_l
十	sh ib_l ib_h
千	qi a_h nn_h
卅	s a_h a_l
升	sh el_h ng_h
午	wu u_l u_l
卉	hu eh_h i_l
半	b a_h nn_l
半	b a_m nn_m
华	hu a_h a_h
华	hu a_h a_l
华	hu a_l a_h
协	xi eh_l eh_h
卑	b eh_h i_h
卒	cu u_h u_l
卒	zu u_l u_h
卓	zhu o_l o_h
单	ch a_l nn_h
单	d a_h nn_h
单	sh a_h nn_l
卖	m a_h eh_l
卖	m a_m eh_m
南	n a_h a_h
南	n a_l nn_h
博	bu o_l o_h
卜	bu o_m o_m
卜	bu u_l u_l
卞	bi a_h nn_l
卟	bu u_l u_l
占	zh a_h nn_h
占	zh a_h nn_l
卡	k a_l a_l
卡	qi a_l a_l
卢	lu u_l u_h
卤	lu u_l u_l
卦	gu a_h a_l
卧	wu o_h o_l
卧	wu o_m o_m
卫	wu eh_h i_l
卮	zh ib_h ib_h
卯	m aa_l o_l
印	yi i_h nn_l
危	wu eh_h i_h
即	ji i_l i_h
却	qv eh_h eh_l
卵	lu a_l nn_l
卷	jv a_h nn_l
卷	jv a_l nn_l
卸	xi eh_h eh_l
卿	qi el_h ng_h
厂	a_h nn_h
厂	ch aa_l ng_l
厄	el_h el_l
厅	ti el_h ng_h
历	li i_h i_l
厉	li i_h i_l
压	yi a_h a_h
压	yi a_h a_l
厌	yi a_h a_h
厌	yi a_h nn_l
厍	sh el_h el_l
厕	c el_h el_l
厕	s if_m if_m
厘	li i_l i_h
厚	h o_h u_l
厝	cu o_h o_l
原	yv a_l nn_h
厢	xi aa_h ng_h
厥	jv eh_l eh_h
厦	sh a_h a_l
厦	xi a_h a_l
厨	chu u_l u_h
厩	ji o_h u_l
厮	s if_h if_h
厶	s if_h if_h
去	qv v_h v_l
去	qv v_m v_m
县	xi a_h nn_l
叁	s a_h nn_h
参	c a_h nn_h
参	c el_h nn_h
参	sh el_h nn_h
又	yi o_h u_l
叉	ch a_h a_h
叉	ch a_h a_l
叉	ch a_l a_h
叉	ch a_l a_l
及	ji i_l i_h
友	yi o_l u_l
友	yi o_m u_m
双	shu aa_h ng_h
反	f a_l nn_l
发	f a_h a_h
发	f a_h a_l
发	f a_m a_m
叔	shu u_h u_h
取	qv v_l v_l
受	sh o_h u_l
变	bi a_h nn_l
叙	xv v_h v_l
叛	p a_h nn_l
叟	s o_l u_l
叠	di eh_l eh_h
口	k o_l u_l
口	k o_m u_m
古	gu u_l u_l
句	g o_h u_h
句	jv v_h v_l
另	li el_h ng_l
叨	d aa_h o_h
叨	d aa_l o_h
叨	d aa_m o_m
叨	t aa_h o_h
叩	k o_h u_l
只	zh ib_h ib_h
只	zh ib_l ib_l
叫	ji aa_h o_l
召	sh aa_h o_l
召	zh aa_h o_l
叭	b a_h a_h
叭	b a_m a_m
叮	di el_h ng_h
可	k el_h el_l
可	k el_l el_l
台	t a_h eh_h
台	t a_l eh_h
台	t a_m eh_m
叱	ch ib_h ib_l
史	sh ib_l ib_l
右	yi o_h u_l
叵	pu o_l o_l
叶	xi eh_l eh_h
叶	yi eh_h eh_l
号	h aa_h o_l
号	h aa_l o_h
号	h aa_m o_m
司	s if_h if_h
司	s if_m if_m
叹	t a_h nn_l
叻	l el_h el_l
叼	di aa_h o_h
叽	ji i_h i_h
叽	ji i_m i_m
吁	xv v_h v_h
吁	yv v_h v_h
吁	yv v_h v_l
吃	ch ib_h ib_h
各	g el_h el_l
各	g el_l el_l
吆	yi aa_h o_h
合	g el_l el_l
合	h el_l el_h
合	h el_m el_m
吉	ji i_l i_h
吉	ji i_m i_m
吊	di aa_h o_l
同	tu u_h ng_l
同	tu u_l ng_h
同	tu u_m ng_m
名	mi el_l ng_h
后	h o_h u_l
吏	li i_h i_l
吐	tu u_h u_l
吐	tu u_l u_l
向	xi aa_h ng_l
吒	zh a_h a_h
吒	zh a_h a_l
吓	h el_h el_l
吓	xi a_h a_l
吕	lv v_l v_l
吖	a_h a_h
吗	m a_l a_h
吗	m a_l a_l
吗	m a_m a_m
君	jv el_h nn_h
吝	li i_h nn_l
吞	tu el_h nn_h
吟	yi i_l nn_h
吠	f eh_h i_l
吡	bi i_l i_l
吡	pi i_l i_l
否	f o_l u_l
否	pi i_l i_l
吧	b a_h a_h
吧	b a_m a_m
吨	du el_h nn_h
吩	f el_h nn_h
含	h a_l nn_h
含	h a_m nn_m
听	ti el_h ng_h
听	ti el_m ng_m
吭	h aa_l ng_h
吭	k el_h ng_h
吮	shu el_l nn_l
启	qi i_l i_l
吱	zh ib_h ib_h
吱	z if_h if_h
吲	yi i_l nn_l
吴	wu u_l u_h
吵	ch aa_h o_h
吵	ch aa_l o_l
吵	ch aa_m o_m
吸	xi i_h i_h
吹	chu eh_h i_h
吻	wu el_l nn_l
吼	h o_l u_l
吾	wu u_l u_h
呀	yi a_h a_h
呀	yi a_m a_m
呃	el_h el_l
呃	el_m el_m
呆	d a_h eh_h
呈	ch el_l ng_h
告	g aa_h o_l
呋	fu u_h u_h
呐	n a_h a_l
呐	n a_m a_m
呐	n el_h el_l
呐	n el_m el_m
呓	yi i_h i_l
呔	d a_h eh_h
呔	t a_l eh_l
呕	o_l u_l
呖	li i_h i_l
呗	b a_h eh_l
呗	b eh_m i_m
员	yv a_l nn_h
员	yv el_h nn_l
员	yv el_l nn_h
呙	gu o_h o_h
呛	qi aa_h ng_h
呛	qi aa_h ng_l
呛	qi aa_m ng_m
呜	wu u_h u_h
呢	n el_m el_m
呢	ni i_l i_h
呢	ni i_m i_m
呤	li el_h ng_l
呦	yi o_h u_h
周	zh o_h u_h
呱	gu a_h a_h
呱	gu a_l a_l
呱	gu u_h u_h
呱	p a_h eh_l
呲	c if_h if_h
呲	z if_h if_h
味	wu eh_h i_l
呵	a_h a_h
呵	a_h a_l
呵	a_l a_h
呵	a_l a_l
呵	h el_h el_h
呵	k el_h el_h
呶	n aa_l o_h
呷	g a_h a_h
呷	xi a_h a_h
呸	p eh_h i_h
呻	sh el_h nn_h
呼	hu u_h u_h
呼	hu u_m u_m
命	mi el_h ng_l
咀	jv v_l v_l
咀	zu eh_l i_l
咂	z a_h a_h
咆	p aa_l o_h
咋	z a_l a_l
咋	z el_l el_h
咋	zh a_h a_h
和	h el_h el_l
和	h el_l el_h
和	h el_m el_m
和	hu o_h o_l
和	hu o_l o_h
和	hu o_m o_m
和	hu u_l u_h
咎	ji o_h u_l
咏	yi u_l ng_l
咐	fu u_h u_l
咒	zh o_h u_l
咔	k a_h a_h
咔	k a_l a_l
咕	gu u_h u_h
咕	gu u_m u_m
咖	g a_h a_h
咖	k a_h a_h
咙	lu u_l ng_h
咚	du u_h ng_h
咛	ni el_l ng_h
咝	s if_h if_h
咣	gu aa_h ng_h
咤	zh a_h a_l
咦	yi i_l i_h
咧	li eh_h eh_h
咧	li eh_l eh_l
咧	li eh_m eh_m
咨	z if_h if_h
咩	mi eh_h eh_h
咪	mi i_h i_h
咫	zh ib_l ib_l
咬	yi aa_l o_l
咭	ji i_h i_h
咯	g el_h el_h
咯	k a_l a_l
咯	lu o_h o_l
咯	lu o_m o_m
咱	z a_l a_h
咱	z a_l nn_h
咱	z a_m nn_m
咳	h a_h eh_h
咳	k el_l el_h
咸	xi a_l nn_h
咻	xi o_h u_h
咽	yi a_h nn_h
咽	yi a_h nn_l
咽	yi eh_h eh_l
咿	yi i_h i_h
哀	a_h eh_h
品	pi i_l nn_l
哄	hu u_h ng_h
哄	hu u_h ng_l
哄	hu u_l ng_l
哄	hu u_m ng_m
哆	ch ib_l ib_l
哆	du o_h o_h
哆	du o_m o_m
哇	wu a_h a_h
哇	wu a_m a_m
哈	h a_h a_h
哈	h a_h a_l
哈	h a_l a_l
哈	h a_m a_m
哉	z a_h eh_h
哌	p a_h eh_l
响	xi aa_l ng_l
哎	a_h eh_h
哎	a_h eh_l
哎	a_l eh_l
哏	g el_l nn_h
哐	ku aa_h ng_h
哑	el_h el_l
哑	yi a_h a_h
哑	yi a_l a_l
哒	d a_h a_h
哓	xi aa_h o_h
哔	bi i_h i_l
哗	hu a_h a_h
哗	hu a_l a_h
哙	ku a_h eh_l
哚	du o_l o_l
哝	nu u_l ng_h
哝	nu u_m ng_m
哞	m o_h u_h
哞	m o_l u_h
哟	yi o_h o_h
哟	yi o_m o_m
哥	g el_h el_h
哥	g el_m el_m
哦	el_l el_h
哦	o_h o_l
哦	o_l o_h
哧	ch ib_h ib_h
哨	sh aa_h o_l
哩	li i_h i_h
哩	li i_l i_l
哩	li i_m i_m
哪	n a_l a_l
哪	n a_l eh_l
哪	n a_m a_m
哪	n eh_l i_l
哪	n el_l el_h
哭	ku u_h u_h
哮	xi aa_h o_l
哲	zh el_l el_h
哳	zh a_h a_h
哺	bu u_l u_l
哼	h el_h ng_h
哼	h el_m ng_m
哿	g el_l el_l
唆	su o_h o_h
唆	su o_m o_m
唇	chu el_l nn_h
唉	a_h eh_h
唉	a_h eh_l
唏	xi i_h i_h
唐	t aa_l ng_h
唔	el_l nn_h
唔	wu u_l u_h
唛	m a_h a_l
唛	m a_h eh_l
唠	l aa_h o_l
唠	l aa_l o_h
唠	l aa_m o_m
唢	su o_l o_l
唤	hu a_h nn_l
唧	ji i_h i_h
唧	ji i_m i_m
唬	hu u_l u_l
唬	hu u_m u_m
唬	xi a_h a_l
售	sh o_h u_l
唯	wu eh_l i_h
唯	wu eh_l i_l
唰	shu a_h a_h
唱	ch aa_h ng_l
唷	yi o_h o_h
唼	sh a_h a_l
啁	zh aa_h o_h
啁	zh o_h u_h
啃	k el_l nn_l
啄	zhu o_l o_h
商	sh aa_h ng_h
啉	li i_l nn_h
啊	a_h a_h
啊	a_h a_l
啊	a_l a_h
啊	a_l a_l
啊	a_m a_m
啕	t aa_l o_h
啖	d a_h nn_l
啜	chu a_h eh_l
啜	chu o_h o_l
啡	f eh_h i_h
啤	pi i_l i_h
啥	sh a_l a_h
啦	l a_h a_h
啦	l a_m a_m
啧	z el_l el_h
啪	p a_h a_h
啬	s el_h el_l
啮	ni eh_h eh_l
啵	bu o_m o_m
啷	l aa_h ng_h
啸	xi aa_h o_l
啼	ti i_l i_h
啾	ji o_h u_h
喀	k a_h a_h
喂	wu eh_h i_l
喂	wu eh_l i_h
喃	n a_l nn_h
善	sh a_h nn_l
喇	l a_h a_h
喇	l a_l a_h
喇	l a_l a_l
喇	l a_m a_m
喈	ji eh_h eh_h
喉	h o_l u_h
喊	h a_l nn_l
喋	di eh_l eh_h
喋	zh a_l a_h
喏	nu o_h o_l
喏	r el_l el_l
喑	yi i_h nn_h
喔	o_h o_h
喔	wu o_h o_h
喘	chu a_l nn_l
喙	hu eh_h i_l
喜	xi i_l i_l
喝	h el_h el_h
喝	h el_h el_l
喝	h el_m el_m
喧	xv a_h nn_h
喯	b el_h nn_h
喯	p el_h nn_l
喱	li i_l i_h
喳	ch a_h a_h
喳	zh a_h a_h
喵	mi aa_h o_h
喷	p el_h nn_h
喷	p el_h nn_l
喷	p el_m nn_m
喹	ku eh_l i_h
喻	yv v_h v_l
喽	l o_l u_h
喽	l o_m u_m
喾	ku u_h u_l
嗄	a_l a_h
嗄	sh a_h a_l
嗅	xi o_h u_l
嗉	su u_h u_l
嗍	su o_h o_h
嗑	k el_h el_h
嗑	k el_h el_l
嗒	d a_h a_h
嗒	d a_m a_m
嗒	t a_h a_l
嗓	s aa_l ng_l
嗖	s o_h u_h
嗜	sh ib_h ib_l
嗝	g el_l el_h
嗡	wu el_h ng_h
嗣	s if_h if_l
嗦	su o_h o_h
嗦	su o_m o_m
嗨	h a_h eh_h
嗨	h eh_h i_h
嗬	h el_h el_h
嗯	el_h ng_l
嗯	el_h nn_l
嗯	el_l ng_h
嗯	el_l ng_l
嗯	el_l nn_h
嗯	el_l nn_l
嗲	di a_l a_l
嗳	a_h eh_h
嗳	a_h eh_l
嗳	a_l eh_l
嗵	tu u_h ng_h
嗷	aa_l o_h
嗽	s o_h u_l
嗽	s o_m u_m
嗾	s o_l u_l
嘀	di i_h i_h
嘀	di i_l i_h
嘈	c aa_l o_h
嘉	ji a_h a_h
嘎	g a_h a_h
嘎	g a_l a_h
嘎	g a_l a_l
嘏	gu u_l u_l
嘏	ji a_l a_l
嘘	sh ib_h ib_h
嘘	xv v_h v_h
嘛	m a_l a_h
嘛	m a_m a_m
嘞	l eh_m i_m
嘞	l el_h el_h
嘟	du u_h u_h
嘣	b el_h ng_h
嘤	yi el_h ng_h
嘬	chu a_h eh_l
嘬	zhu a_h eh_l
嘬	zu o_h o_h
嘭	p el_h ng_h
嘱	zhu u_l u_l
嘲	ch aa_l o_h
嘲	zh aa_h o_h
嘴	zu eh_l i_l
嘶	s if_h if_h
嘹	li aa_l o_h
嘻	xi i_h i_h
嘿	h a_h eh_h
嘿	h eh_h i_h
嘿	mu o_h o_l
噌	c el_h ng_h
噌	ch el_h ng_h
噎	yi eh_h eh_h
噔	d el_h ng_h
噗	pu u_h u_h
噘	jv eh_h eh_h
噜	lu u_h u_h
噜	lu u_m u_m
噢	o_h o_h
器	qi i_h i_l
噪	z aa_h o_l
噫	yi i_h i_h
噬	sh ib_h ib_l
噶	g a_l a_h
噻	s a_h eh_h
噻	s a_m eh_m
噼	pi i_h i_h
嚎	h aa_l o_h
嚓	c a_h a_h
嚓	ch a_h a_h
嚣	aa_l o_h
嚣	xi aa_h o_h
嚯	hu o_h o_l
嚷	r aa_h ng_h
嚷	r aa_l ng_l
嚷	r aa_m ng_m
嚼	ji aa_h o_l
嚼	ji aa_l o_h
嚼	jv eh_l eh_h
囊	n aa_h ng_h
囊	n aa_l ng_h
囊	n aa_m ng_m
囗	wu eh_l i_h
囚	qi o_l u_h
四	s if_h if_l
4	s if_h if_l
囝	ji a_l nn_l
回	hu eh_l i_h
囟	xi i_h nn_l
因	yi i_h nn_h
囡	n a_h nn_h
团	tu a_l nn_h
囤	du el_h nn_l
囤	tu el_l nn_h
囫	hu u_l u_h
园	yv a_l nn_h
困	ku el_h nn_l
囱	cu u_h ng_h
围	wu eh_l i_h
囵	lu el_l nn_h
固	gu u_h u_l
国	gu o_l o_h
图	tu u_l u_h
囿	yi o_h u_l
圃	pu u_l u_l
圆	yv a_l nn_h
圈	jv a_h nn_h
圈	jv a_h nn_l
圈	qv a_h nn_h
圈	qv a_m nn_m
圉	yv v_l v_l
圊	qi el_h ng_h
圜	hu a_l nn_h
圜	yv a_l nn_h
土	tu u_l u_l
圣	sh el_h ng_l
在	z a_h eh_l
圩	wu eh_l i_h
圩	xv v_h v_h
圪	g el_h el_h
圬	wu u_h u_h
圭	gu eh_h i_h
圮	pi i_l i_l
圯	yi i_l i_h
地	d el_m el_m
地	di i_h i_l
地	di i_m i_m
圳	zh el_h nn_l
圹	ku aa_h ng_l
场	ch aa_l ng_h
场	ch aa_l ng_l
圻	qi i_l i_h
圻	yi i_l nn_h
圾	ji i_h i_h
址	zh ib_l ib_l
坂	b a_l nn_l
均	jv el_h nn_h
坊	f aa_h ng_h
坊	f aa_l ng_h
坊	f aa_m ng_m
坌	b el_h nn_l
坍	t a_h nn_h
坎	k a_l nn_l
坏	hu a_h eh_l
坏	pi i_h i_h
坐	zu o_h o_l
坑	k el_h ng_h
块	ku a_h eh_l
坚	ji a_h nn_h
坛	t a_l nn_h
坜	li i_h i_l
坝	b a_h a_l
坞	wu u_h u_l
坟	f el_l nn_h
坠	zhu eh_h i_l
坡	pu o_h o_h
坤	ku el_h nn_h
坦	t a_l nn_l
坨	tu o_l o_h
坩	g a_h nn_h
坪	pi el_l ng_h
坫	di a_h nn_l
坭	ni i_l i_h
坯	pi i_h i_h
坳	aa_h o_l
坶	mu u_h u_l
坶	mu u_l u_l
坷	k el_h el_h
坷	k el_l el_l
坻	ch ib_l ib_h
坻	di i_l i_l
坼	ch el_h el_l
垂	chu eh_l i_h
垃	l a_h a_h
垄	lu u_l ng_l
垅	lu u_l ng_l
垆	lu u_l u_h
型	xi el_l ng_h
垌	du u_h ng_l
垌	tu u_l ng_h
垒	l eh_l i_l
垓	g a_h eh_h
垛	du o_h o_l
垛	du o_l o_l
垠	yi i_l nn_h
垡	f a_l a_h
垢	g o_h u_l
垣	yv a_l nn_h
垤	di eh_l eh_h
垦	k el_l nn_l
垧	sh aa_l ng_l
垩	el_h el_l
垫	di a_h nn_l
垭	el_h el_l
垭	yi a_h a_h
垭	yi a_h a_l
垮	ku a_l a_l
垲	k a_l eh_l
垴	n aa_l o_l
垸	yv a_h nn_l
埂	g el_l ng_l
埃	a_h eh_h
埋	m a_l eh_h
埋	m a_l nn_h
城	ch el_l ng_h
埏	sh a_h nn_h
埏	yi a_l nn_h
埒	li eh_h eh_l
埔	bu u_h u_l
埔	pu u_l u_l
埕	ch el_l ng_h
埘	sh ib_l ib_h
埙	xv el_h nn_h
埚	gu o_h o_h
埝	ni a_h nn_l
域	yv v_h v_l
埠	bu u_h u_l
埤	pi i_h i_l
埤	pi i_l i_h
埭	d a_h eh_l
埯	a_l nn_l
埴	zh ib_l ib_h
埸	yi i_h i_l
培	p eh_l i_h
基	ji i_h i_h
埽	s aa_h o_l
堀	ku u_h u_h
堂	t aa_l ng_h
堆	du eh_h i_h
堇	ji i_h nn_l
堇	ji i_l nn_l
堇	qi i_l nn_h
堋	p el_l ng_h
堍	tu u_h u_l
堑	qi a_h nn_l
堕	du o_h o_l
堕	hu eh_h i_h
堙	yi i_h nn_h
堠	h o_h u_l
堡	b aa_l o_l
堡	bu u_l u_l
堡	pu u_h u_l
堤	di i_h i_h
堪	k a_h nn_h
堰	yi a_h nn_l
堵	du u_l u_l
塄	l el_l ng_h
塌	t a_h a_h
塌	t a_m a_m
塍	ch el_l ng_h
塑	su u_h u_l
塔	d a_m a_m
塔	t a_l a_l
塘	t aa_l ng_h
塞	s a_h eh_h
塞	s a_h eh_l
塞	s el_h el_l
塥	g el_l el_h
填	ti a_l nn_h
塬	yv a_l nn_h
塾	shu u_l u_h
墀	ch ib_l ib_h
墁	m a_h nn_l
境	ji el_h ng_l
墅	shu u_h u_l
墉	yi u_h ng_h
墒	sh aa_h ng_h
墓	mu u_h u_l
墙	qi aa_l ng_h
增	z el_h ng_h
墟	xv v_h v_h
墨	mu o_h o_l
墩	du el_h nn_h
墼	ji i_h i_h
壁	bi i_h i_l
壅	yi u_h ng_h
壑	h el_h el_l
壕	h aa_l o_h
壤	r aa_l ng_l
士	sh ib_h ib_l
士	sh ib_m ib_m
壬	r el_l nn_h
壮	zhu aa_h ng_l
声	sh el_h ng_h
声	sh el_m ng_m
壳	k el_l el_h
壳	k el_m el_m
壳	qi aa_h o_l
壶	hu u_l u_h
壹	yi i_h i_h
处	chu u_h u_l
处	chu u_l u_l
处	chu u_m u_m
备	b eh_h i_l
复	fu u_h u_l
夏	xi a_h a_l
夔	ku eh_l i_h
夕	xi i_h i_h
外	wu a_h eh_l
夙	su u_h u_l
多	du o_h o_h
夜	yi eh_h eh_l
够	g o_h u_l
夥	hu o_l o_l
大	d a_h a_l
大	d a_h eh_l
大	d a_m a_m
天	ti a_h nn_h
太	t a_h eh_l
夫	fu u_h u_h
夫	fu u_l u_h
夫	fu u_m u_m
夭	wu a_h eh_h
夭	yi aa_h o_h
央	yi aa_h ng_h
夯	b el_h nn_l
夯	h aa_h ng_h
失	sh ib_h ib_h
失	sh ib_m ib_m
头	t o_l u_h
头	t o_m u_m
夷	yi i_l i_h
夸	ku a_h a_h
夹	g a_h a_h
夹	ji a_h a_h
夹	ji a_l a_h
夺	du o_l o_h
夼	ku aa_l ng_l
奁	li a_l nn_h
奂	hu a_h nn_l
奄	yi a_h nn_h
奄	yi a_l nn_l
奇	ji i_h i_h
奇	qi i_l i_h
奈	n a_h eh_l
奉	f el_h ng_l
奋	f el_h nn_l
奎	ku eh_l i_h
奏	z o_h u_l
契	qi i_h i_l
契	xi eh_h eh_l
奔	b el_h nn_h
奔	b el_h nn_l
犇	b el_h nn_h
犇	b el_h nn_l
奕	yi i_h i_l
奖	ji aa_l ng_l
套	t aa_h o_l
奘	z aa_h ng_l
奘	zhu aa_l ng_l
奚	xi i_h i_h
奠	di a_h nn_l
奢	sh el_h el_h
奥	aa_h o_l
女	nv v_l v_l
奴	nu u_l u_h
奶	n a_l eh_l
奶	n a_m eh_m
奸	ji a_h nn_h
她	t a_h a_h
好	h aa_h o_l
好	h aa_l o_l
如	ru u_l u_h
妃	f eh_h i_h
妄	wu aa_h ng_l
妆	zhu aa_h ng_h
妆	zhu aa_m ng_m
妇	fu u_h u_l
妇	fu u_m u_m
妈	m a_h a_h
妊	r el_h nn_l
妍	yi a_l nn_h
妒	du u_h u_l
妖	yi aa_h o_h
妗	ji i_h nn_l
妙	mi aa_h o_l
妞	ni o_h u_h
妤	yv v_l v_h
妥	tu o_l o_l
妨	f aa_h ng_h
妨	f aa_l ng_h
妩	wu u_l u_l
妪	yv v_h v_l
妪	yv v_l v_l
妫	gu eh_h i_h
妮	ni i_h i_h
妯	zh o_l u_h
妲	d a_l a_h
妹	m eh_h i_l
妻	qi i_h i_h
妻	qi i_h i_l
妾	qi eh_h eh_l
姆	mu u_l u_l
姊	z if_l if_l
始	sh ib_l ib_l
姐	ji eh_l eh_l
姑	gu u_h u_h
姒	s if_h if_l
姓	xi el_h ng_l
委	wu eh_h i_h
委	wu eh_l i_l
姗	sh a_h nn_h
姘	pi i_h nn_h
姚	yi aa_l o_h
姜	ji aa_h ng_h
姝	shu u_h u_h
姣	ji aa_h o_h
姥	l aa_l o_l
姥	l aa_m o_m
姥	mu u_l u_l
姨	yi i_l i_h
姨	yi i_m i_m
姬	ji i_h i_h
姹	ch a_h a_l
姻	yi i_h nn_h
姿	z if_h if_h
威	wu eh_h i_h
娃	wu a_l a_h
娄	l o_l u_h
娅	yi a_h a_l
娆	r aa_l o_h
娆	r aa_l o_l
娇	ji aa_h o_h
娈	lu a_l nn_h
娉	pi el_h ng_h
娌	li i_l i_l
娑	su o_h o_h
娓	wu eh_l i_l
娘	ni aa_l ng_h
娘	ni aa_m ng_m
娜	n a_h a_l
娜	nu o_l o_h
娟	jv a_h nn_h
娠	sh el_h nn_h
娣	di i_h i_l
娥	el_l el_h
娩	mi a_l nn_l
娩	wu a_l nn_l
娱	yv v_l v_h
娲	wu a_h a_h
娴	xi a_l nn_h
娶	qv v_l v_l
婀	el_h el_h
婆	pu o_l o_h
婉	wu a_l nn_l
婕	ji eh_l eh_h
婚	hu el_h nn_h
婢	bi i_h i_l
婧	ji el_h ng_l
婪	l a_l nn_h
婴	yi el_h ng_h
婵	ch a_l nn_h
婶	sh el_l nn_l
婷	ti el_l ng_h
婺	wu u_h u_l
婿	xv v_h v_l
婿	xv v_m v_m
媒	m eh_l i_h
媚	m eh_h i_l
媛	yv a_h nn_l
媛	yv a_l nn_h
媲	pi i_h i_l
媳	xi i_l i_h
媸	ch ib_h ib_h
嫁	ji a_h a_l
嫂	s aa_l o_l
嫉	ji i_l i_h
嫌	xi a_l nn_h
嫒	a_h eh_l
嫔	pi i_l nn_h
嫘	l eh_l i_h
嫡	di i_l i_h
嫣	yi a_h nn_h
嫦	ch aa_l ng_h
嫩	n el_h nn_l
嫫	mu o_l o_h
嫱	qi aa_l ng_h
嬉	xi i_h i_h
嬗	sh a_h nn_l
嬴	yi el_l ng_h
嬷	mu o_l o_h
嬷	mu o_m o_m
子	z if_l if_l
子	z if_m if_m
孑	ji eh_l eh_h
孓	jv eh_l eh_h
孔	ku u_l ng_l
孕	yv el_h nn_l
字	z if_h if_l
存	cu el_l nn_h
孙	su el_h nn_h
孚	fu u_l u_h
孛	b eh_h i_l
孛	bu o_l o_h
孜	z if_h if_h
孝	xi aa_h o_l
孟	m el_h ng_l
孢	b aa_h o_h
季	ji i_h i_l
孤	gu u_h u_h
孤	gu u_m u_m
学	xv eh_l eh_h
孩	h a_l eh_h
孪	lu a_l nn_h
孬	n aa_h o_h
孰	shu u_l u_h
孱	c a_h nn_l
孱	ch a_l nn_h
孵	fu u_h u_h
孺	ru u_l u_h
孽	ni eh_h eh_l
宁	ni el_h ng_l
宁	ni el_l ng_h
它	t a_h a_h
宅	zh a_l eh_h
宇	yv v_l v_l
守	sh o_l u_l
安	a_h nn_h
宋	su u_h ng_l
完	wu a_l nn_h
宏	hu u_l ng_h
宓	fu u_l u_h
宓	mi i_h i_l
宕	d aa_h ng_l
宗	zu u_h ng_h
官	gu a_h nn_h
宙	zh o_h u_l
定	di el_h ng_l
宛	wu a_l nn_l
宜	yi i_l i_h
宜	yi i_m i_m
宝	b aa_l o_l
实	sh ib_l ib_h
实	sh ib_m ib_m
宠	chu u_l ng_l
审	sh el_l nn_l
客	k el_h el_l
宣	xv a_h nn_h
室	sh ib_h ib_l
宥	yi o_h u_l
宦	hu a_h nn_l
宪	xi a_h nn_l
宪	xi a_l nn_l
宫	gu u_h ng_h
宰	z a_l eh_l
害	h a_h eh_l
宴	yi a_h nn_l
宵	xi aa_h o_h
家	gu u_h u_h
家	ji a_h a_h
家	ji a_m a_m
家	ji eh_h eh_h
家	ji eh_m eh_m
宸	ch el_l nn_h
容	ru u_l ng_h
宽	ku a_h nn_h
宾	bi i_h nn_h
宿	su u_h u_l
宿	xi o_h u_l
宿	xi o_l u_l
寂	ji i_h i_l
寄	ji i_h i_l
寅	yi i_l nn_h
密	mi i_h i_l
寇	k o_h u_l
富	fu u_h u_l
寐	m eh_h i_l
寒	h a_l nn_h
寓	yv v_h v_l
寝	qi i_l nn_l
寞	mu o_h o_l
察	ch a_l a_h
寡	gu a_l a_l
寥	li aa_l o_h
寨	zh a_h eh_l
寮	li aa_l o_h
寰	hu a_l nn_h
寸	cu el_h nn_l
寸	cu el_m nn_m
对	du eh_h i_l
对	du eh_m i_m
寺	s if_h if_l
寻	xi i_l nn_h
寻	xv el_l nn_h
导	d aa_l o_l
寿	sh o_h u_l
封	f el_h ng_h
射	sh el_h el_l
将	ji aa_h ng_h
将	ji aa_h ng_l
将	qi aa_h ng_h
尉	wu eh_h i_l
尉	yv v_h v_l
尊	zu el_h nn_h
小	xi aa_l o_l
少	sh aa_h o_l
少	sh aa_l o_l
尔	er_l er_l
尕	g a_l a_l
尖	ji a_h nn_h
尘	ch el_l nn_h
尚	sh aa_h ng_l
尚	sh aa_m ng_m
尜	g a_l a_h
尜	g a_m a_m
尝	ch aa_l ng_h
尢	wu aa_h ng_h
尢	yi o_l u_h
尤	yi o_l u_h
尧	yi aa_l o_h
尬	g a_h a_l
就	ji o_h u_l
就	ji o_m u_m
尸	sh ib_h ib_h
尹	yi i_l nn_l
尺	ch el_l el_l
尺	ch ib_l ib_l
尼	ni i_l i_h
尽	ji i_h nn_l
尽	ji i_l nn_l
尾	wu eh_l i_l
尾	yi i_l i_l
尿	ni aa_h o_l
尿	su eh_h i_h
局	jv v_l v_h
屁	pi i_h i_l
层	c el_l ng_h
屄	bi i_h i_h
居	jv v_h v_h
屈	qv v_h v_h
屈	qv v_m v_m
屉	ti i_h i_l
届	ji eh_h eh_l
屋	wu u_h u_h
屎	sh ib_l ib_l
屏	bi el_h ng_h
屏	bi el_l ng_l
屏	pi el_l ng_h
屐	ji i_h i_h
屑	xi eh_h eh_l
展	zh a_l nn_l
屙	el_h el_h
屙	k el_h el_h
属	shu u_l u_l
属	zhu u_l u_l
屠	tu u_l u_h
屡	lv v_l v_l
屣	xi i_l i_l
履	lv v_l v_l
屦	jv v_h v_l
屯	tu el_l nn_h
屯	zhu el_h nn_h
山	sh a_h nn_h
屹	g el_h el_h
屹	yi i_h i_l
屺	qi i_l i_l
屿	yv v_l v_l
岁	su eh_h i_l
岂	qi i_l i_l
岈	yi a_l a_h
岌	ji i_l i_h
岍	qi a_h nn_h
岐	qi i_l i_h
岑	c el_l nn_h
岔	ch a_h a_l
岖	qv v_h v_h
岗	g aa_h ng_h
岗	g aa_h ng_l
岗	g aa_l ng_l
岘	xi a_h nn_l
岙	aa_h o_l
岚	l a_l nn_h
岛	d aa_l o_l
岜	b a_h a_h
岢	k el_l el_l
岣	g o_l u_l
岩	yi a_l nn_h
岫	xi o_h u_l
岬	ji a_l a_l
岭	li el_l ng_h
岭	li el_l ng_l
岱	d a_h eh_l
岳	yv eh_h eh_l
岵	hu u_h u_l
岷	mi i_l nn_h
岸	a_h nn_l
岽	du u_h ng_h
岿	ku eh_h i_h
峁	m aa_l o_l
峄	yi i_h i_l
峒	du u_h ng_l
峒	tu u_l ng_h
峙	sh ib_h ib_l
峙	zh ib_h ib_l
峡	xi a_l a_h
峤	ji aa_h o_l
峤	qi aa_l o_h
峥	zh el_h ng_h
峦	lu a_l nn_h
峨	el_l el_h
峪	yv v_h v_l
峭	qi aa_h o_l
峰	f el_h ng_h
峻	jv el_h nn_l
崂	l aa_l o_h
崃	l a_l eh_h
崆	ku u_h ng_h
崇	chu u_l ng_h
崎	qi i_l i_h
崔	cu eh_h i_h
崖	a_l eh_h
崖	yi a_l a_h
崚	li el_l ng_h
崛	jv eh_l eh_h
崞	gu o_h o_h
崤	xi aa_l o_h
崦	yi a_h nn_h
崧	su u_h ng_h
崩	b el_h ng_h
崭	ch a_l nn_h
崭	zh a_l nn_l
崮	gu u_h u_l
崴	wu a_l eh_l
崴	wu eh_h i_h
崽	z a_l eh_l
崾	yi aa_l o_l
嵇	ji i_h i_h
嵊	sh el_h ng_l
嵋	m eh_l i_h
嵌	k a_h nn_l
嵌	qi a_h nn_l
嵘	ru u_l ng_h
嵛	yv v_l v_h
嵝	l o_l u_l
嵩	su u_h ng_h
嵫	z if_h if_h
嵬	wu eh_l i_h
嵯	cu o_l o_h
嶂	zh aa_h ng_l
嶙	li i_l nn_h
嶝	d el_h ng_l
嶷	yi i_l i_h
巅	di a_h nn_h
巍	wu eh_h i_h
川	chu a_h nn_h
州	zh o_h u_h
巡	xv el_l nn_h
巢	ch aa_l o_h
工	gu u_h ng_h
左	zu o_l o_l
巧	qi aa_l o_l
巨	jv v_h v_l
巩	gu u_l ng_l
巫	wu u_h u_h
差	ch a_h a_h
差	ch a_h a_l
差	ch a_h eh_h
差	ch a_h eh_l
差	c if_h if_h
己	ji i_l i_l
已	yi i_l i_l
巳	s if_h if_l
巴	b a_h a_h
巴	b a_m a_m
巷	h aa_h ng_l
巷	xi aa_h ng_l
巽	xv el_h nn_l
巾	ji i_h nn_h
币	bi i_h i_l
市	sh ib_h ib_l
市	sh ib_m ib_m
布	bu u_h u_l
帅	shu a_h eh_l
帆	f a_h nn_h
师	sh ib_h ib_h
希	xi i_h i_h
帏	wu eh_l i_h
帐	zh aa_h ng_l
帑	t aa_l ng_l
帕	p a_h a_l
帖	ti eh_h eh_h
帖	ti eh_h eh_l
帖	ti eh_l eh_l
帘	li a_l nn_h
帚	zh o_l u_l
帚	zh o_m u_m
帛	bu o_l o_h
帜	zh ib_h ib_l
帝	di i_h i_l
带	d a_h eh_l
帧	zh el_h ng_l
帧	zh el_h nn_h
席	xi i_l i_h
帮	b aa_h ng_h
帷	wu eh_l i_h
常	ch aa_l ng_h
帼	gu o_l o_h
帽	m aa_h o_l
幂	mi i_h i_l
幄	wu o_h o_l
幅	fu u_l u_h
幌	hu aa_l ng_l
幔	m a_h nn_l
幕	mu u_h u_l
幛	zh aa_h ng_l
幞	fu u_l u_h
幡	f a_h nn_h
幢	chu aa_l ng_h
幢	zhu aa_h ng_l
干	g a_h nn_h
干	g a_h nn_l
干	g a_m nn_m
平	pi el_l ng_h
年	ni a_l nn_h
并	bi el_h ng_h
并	bi el_h ng_l
幸	xi el_h ng_l
幺	yi aa_h o_h
幻	hu a_h nn_l
幼	yi o_h u_l
幽	yi o_h u_h
广	a_h nn_h
广	gu aa_l ng_l
庄	zhu aa_h ng_h
庆	qi el_h ng_l
庇	bi i_h i_l
床	chu aa_l ng_h
序	xv v_h v_l
庐	lu u_l u_h
庑	wu u_l u_l
库	ku u_h u_l
应	yi el_h ng_h
应	yi el_h ng_l
应	yi el_m ng_m
底	d el_m el_m
底	di i_l i_l
庖	p aa_l o_h
店	di a_h nn_l
庙	mi aa_h o_l
庚	g el_h ng_h
府	fu u_l u_l
庞	p aa_l ng_h
废	f eh_h i_l
庠	xi aa_l ng_h
庥	xi o_h u_h
度	du o_l o_h
度	du u_h u_l
度	du u_m u_m
座	zu o_h o_l
庭	ti el_l ng_h
庵	a_h nn_h
庶	shu u_h u_l
康	k aa_h ng_h
庸	yi u_h ng_h
庹	tu o_l o_l
庾	yv v_l v_l
廉	li a_l nn_h
廊	l aa_l ng_h
廒	aa_l o_h
廓	ku o_h o_l
廖	li aa_h o_l
廛	ch a_l nn_h
廨	xi eh_h eh_l
廪	li i_l nn_l
廴	ji a_h nn_l
廴	yi i_h nn_l
廴	yi i_l nn_l
延	yi a_l nn_h
廷	ti el_l ng_h
建	ji a_h nn_l
廾	gu u_l ng_l
廾	nu u_h ng_l
廿	ni a_h nn_l
开	k a_h eh_h
开	sil k a_h eh_h
弁	bi a_h nn_l
异	yi i_h i_l
弃	qi i_h i_l
弄	lu u_h ng_l
弄	nu u_h ng_l
弄	nu u_m ng_m
弈	yi i_h i_l
弋	yi i_h i_l
式	sh ib_h ib_l
式	sh ib_m ib_m
弓	gu u_h ng_h
引	yi i_l nn_l
弗	fu u_l u_h
弘	hu u_l ng_h
弛	ch ib_l ib_h
弟	di i_h i_l
弟	di i_m i_m
张	zh aa_h ng_h
弥	mi i_l i_h
弥	mi i_l i_l
弦	xi a_l nn_h
弧	hu u_l u_h
弩	nu u_l u_l
弭	mi i_l i_l
弯	wu a_h nn_h
弱	ru o_h o_l
弹	d a_h nn_l
弹	t a_l nn_h
弹	t a_m nn_m
强	ji aa_h ng_l
强	qi aa_l ng_h
强	qi aa_l ng_l
弼	bi i_h i_l
彐	ji i_h i_l
彐	xv eh_l eh_l
彐	xv el_l nn_h
归	gu eh_h i_h
当	d aa_h ng_h
当	d aa_h ng_l
当	d aa_m ng_m
录	lu u_h u_l
彖	tu a_h nn_l
彗	hu eh_h i_l
彝	yi i_l i_h
彡	s a_h nn_h
彡	sh a_h nn_h
形	xi el_l ng_h
彤	tu u_l ng_h
彦	yi a_h nn_l
彩	c a_l eh_l
彩	c a_m eh_m
彪	bi aa_h o_h
彬	bi i_h nn_h
彭	p el_l ng_h
彰	zh aa_h ng_h
影	yi el_l ng_l
彳	ch ib_h ib_l
彷	f aa_l ng_l
彷	p aa_l ng_h
役	yi i_h i_l
彻	ch el_h el_l
彼	bi i_l i_l
往	wu aa_h ng_l
往	wu aa_l ng_l
征	zh el_h ng_h
徂	cu u_l u_h
径	ji el_h ng_l
待	d a_h eh_h
待	d a_h eh_l
很	h el_l nn_l
徉	yi aa_l ng_h
徊	hu a_l eh_h
徊	hu eh_l i_h
律	lv v_h v_l
後	h o_h u_l
徐	xv v_l v_h
徒	tu u_l u_h
徕	l a_h eh_l
徕	l a_l eh_h
得	d eh_l i_l
得	d el_l el_h
得	d el_m el_m
徘	p a_l eh_h
徙	xi i_l i_l
徜	ch aa_l ng_h
御	yv v_h v_l
徨	hu aa_l ng_h
循	xv el_l nn_h
徭	yi aa_l o_h
微	wu eh_h i_h
徵	zh el_h ng_h
徵	zh ib_l ib_l
德	d el_l el_h
徽	hu eh_h i_h
心	xi i_h nn_h
心	xi i_m nn_m
必	bi i_h i_l
忆	yi i_h i_l
忌	ji i_h i_l
忍	r el_l nn_l
忏	ch a_h nn_l
忐	t a_l nn_l
忑	t el_h el_l
忒	t eh_h i_h
忒	t el_h el_l
忒	tu eh_h i_h
忖	cu el_l nn_l
志	zh ib_h ib_l
忘	wu aa_h ng_l
忙	m aa_l ng_h
忝	ti a_l nn_l
忠	zhu u_h ng_h
忧	yi o_h u_h
快	ku a_h eh_l
快	ku a_m eh_m
忱	ch el_l nn_h
念	ni a_h nn_l
忻	xi i_h nn_h
忽	hu u_h u_h
忽	hu u_m u_m
怀	hu a_l eh_h
态	t a_h eh_l
怂	su u_l ng_l
怊	ch aa_h o_h
怎	z el_l nn_l
怏	yi aa_h ng_l
怒	nu u_h u_l
怔	zh el_h ng_h
怔	zh el_h ng_l
怔	zh el_m ng_m
怕	p a_h a_l
怖	bu u_h u_l
怛	d a_l a_h
怜	li a_l nn_h
思	s a_h eh_h
思	s if_h if_h
思	s if_m if_m
怡	yi i_l i_h
急	ji i_l i_h
怦	p el_h ng_h
性	xi el_h ng_l
性	xi el_m ng_m
怨	yv a_h nn_l
怩	ni i_l i_h
怪	gu a_h eh_l
怯	qi eh_h eh_l
总	zu u_l ng_l
怿	yi i_h i_l
恁	n el_h nn_l
恁	ni i_l nn_h
恂	xv el_l nn_h
恃	sh ib_h ib_l
恋	li a_h nn_l
恍	hu aa_l ng_l
恐	ku u_l ng_l
恒	h el_l ng_h
恕	shu u_h u_l
恙	yi aa_h ng_l
恢	hu eh_h i_h
恣	z if_h if_l
恤	xv v_h v_l
恨	h el_h nn_l
恩	el_h nn_h
恪	k el_h el_l
恫	du u_h ng_l
恫	tu u_h ng_h
恬	ti a_l nn_h
恭	gu u_h ng_h
息	xi i_h i_h
息	xi i_m i_m
恰	qi a_h a_l
恳	k el_l nn_l
恶	el_h el_l
恶	el_l el_l
恶	wu u_h u_h
恶	wu u_h u_l
恶	wu u_m u_m
恹	yi a_h nn_h
恺	k a_l eh_l
恻	c el_h el_l
恼	n aa_l o_l
恽	yv el_h nn_l
悃	ku el_l nn_l
悄	qi aa_h o_h
悄	qi aa_l o_l
悉	xi i_h i_h
悌	ti i_h i_l
悍	h a_h nn_l
悔	hu eh_l i_l
悚	su u_l ng_l
悟	wu u_h u_l
悠	yi o_h u_h
悠	yi o_m u_m
患	hu a_h nn_l
悦	yv eh_h eh_l
您	ni i_l nn_h
悫	qv eh_h eh_l
悬	xv a_l nn_h
悯	mi i_l nn_l
悲	b eh_h i_h
悸	ji i_h i_l
悻	xi el_h ng_l
悼	d aa_h o_l
情	qi el_l ng_h
情	qi el_m ng_m
惊	ji el_h ng_h
惑	hu o_h o_l
惕	ti i_h i_l
惚	hu u_h u_h
惜	xi i_h i_h
惟	wu eh_l i_h
惠	hu eh_h i_l
惦	di a_h nn_l
惧	jv v_h v_l
惨	c a_l nn_l
惩	ch el_l ng_h
惬	qi eh_h eh_l
惮	d a_h nn_l
惯	gu a_h nn_l
惰	du o_h o_l
想	xi aa_l ng_l
惶	hu aa_l ng_h
惹	r el_l el_l
惺	xi el_h ng_h
愁	ch o_l u_h
愈	yv v_h v_l
愉	yv v_l v_h
愍	mi i_l nn_l
意	yi i_h i_l
意	yi i_m i_m
愚	yv v_l v_h
感	g a_l nn_l
愠	yv el_h nn_l
愠	yv el_l nn_l
愣	l el_h ng_l
愣	l el_m ng_m
愤	f el_h nn_l
愧	ku eh_h i_l
愫	su u_h u_l
愿	yv a_h nn_l
慈	c if_l if_h
慌	hu aa_h ng_h
慎	sh el_h nn_l
慑	sh el_h el_l
慕	mu u_h u_l
慝	t el_h el_l
慢	m a_h nn_l
慧	hu eh_h i_l
慨	k a_l eh_l
慰	wu eh_h i_l
慵	yi u_h ng_h
慷	k aa_h ng_h
憋	bi eh_h eh_h
憔	qi aa_l o_h
憧	chu u_h ng_h
憨	h a_h nn_h
憩	qi i_h i_l
憬	ji el_l ng_l
憾	h a_h nn_l
懂	du u_l ng_l
懈	xi eh_h eh_l
懊	aa_h o_l
懋	m aa_h o_l
懒	l a_l nn_l
懦	nu o_h o_l
懵	m el_l ng_l
懿	yi i_h i_l
戆	g aa_h ng_l
戆	zhu aa_h ng_l
戈	g el_h el_h
戊	wu u_h u_l
戌	qv v_m v_m
戌	xv v_h v_h
戍	shu u_h u_l
戎	ru u_l ng_h
戏	hu u_h u_h
戏	xi i_h i_l
成	ch el_l ng_h
我	wu o_l o_l
戒	ji eh_h eh_l
或	hu o_h o_l
戗	qi aa_h ng_h
戗	qi aa_h ng_l
战	zh a_h nn_l
战	zh a_m nn_m
戚	qi i_h i_h
戚	qi i_m i_m
戛	ji a_l a_h
戟	ji i_l i_l
戢	ji i_l i_h
戤	g a_h eh_l
戥	d el_l ng_l
截	ji eh_l eh_h
戬	ji a_l nn_l
戮	lu u_h u_l
戳	chu o_h o_h
戴	d a_h eh_l
户	hu u_h u_l
户	hu u_m u_m
戽	hu u_h u_l
房	f aa_l ng_h
房	f aa_m ng_m
所	su o_l o_l
扁	bi a_l nn_l
扁	pi a_h nn_h
扇	sh a_h nn_h
扇	sh a_h nn_l
扇	sh a_m nn_m
扈	hu u_h u_l
扉	f eh_h i_h
手	sh o_l u_l
手	sh o_m u_m
扌	sh o_l u_l
扌	ti i_l i_h
才	c a_l eh_h
扎	z a_h a_h
扎	zh a_h a_h
扎	zh a_l a_h
扑	pu u_h u_h
扒	b a_h a_h
扒	p a_l a_h
打	d a_l a_h
打	d a_l a_l
打	d a_m a_m
扔	r el_h ng_h
托	tu o_h o_h
扛	g aa_h ng_h
扛	k aa_l ng_h
扣	k o_h u_l
扦	qi a_h nn_h
执	zh ib_l ib_h
扩	ku o_h o_l
扪	m el_l nn_h
扫	s aa_h o_l
扫	s aa_l o_l
扬	yi aa_l ng_h
扭	ni o_l u_l
扭	ni o_m u_m
扮	b a_h nn_l
扮	b a_m nn_m
扯	ch el_l el_l
扯	ch el_m el_m
扰	r aa_l o_l
扳	b a_h nn_h
扳	p a_h nn_h
扶	fu u_l u_h
批	pi i_h i_h
扼	el_h el_l
找	zh aa_l o_l
承	ch el_l ng_h
承	ch el_m ng_m
技	ji i_h i_l
抄	ch aa_h o_h
抉	jv eh_l eh_h
把	b a_h a_l
把	b a_l a_l
抑	yi i_h i_l
抒	shu u_h u_h
抓	zhu a_h a_h
投	t o_l u_h
抖	d o_l u_l
抗	k aa_h ng_l
折	sh el_l el_h
折	zh el_h el_h
折	zh el_l el_h
抚	fu u_l u_l
抛	p aa_h o_h
抟	tu a_l nn_h
抠	k o_h u_h
抡	lu el_h nn_h
抡	lu el_l nn_h
抢	ch el_h ng_h
抢	qi aa_h ng_h
抢	qi aa_l ng_l
护	hu u_h u_l
报	b aa_h o_l
披	pi i_h i_h
抬	t a_l eh_h
抱	b aa_h o_l
抵	di i_l i_l
抹	m a_h a_h
抹	mu o_h o_l
抹	mu o_l o_l
抻	ch el_h nn_h
押	yi a_h a_h
抽	ch o_h u_h
抿	mi i_l nn_l
拂	bi i_h i_l
拂	fu u_l u_h
拄	zhu u_l u_l
担	d a_h nn_h
担	d a_h nn_l
担	d a_l nn_l
担	d a_m nn_m
拆	c a_h a_h
拆	ch a_h eh_h
拇	mu u_l u_l
拇	mu u_m u_m
拈	ni a_h nn_h
拉	l a_h a_h
拉	l a_h a_l
拉	l a_l a_h
拉	l a_l a_l
拉	l a_m a_m
拌	b a_h nn_l
拍	p a_h eh_h
拎	li i_h nn_h
拐	gu a_l eh_l
拐	gu a_m eh_m
拒	jv v_h v_l
拓	t a_h a_l
拓	tu o_h o_l
拔	b a_l a_h
拖	tu o_h o_h
拗	aa_h o_l
拗	aa_l o_l
拗	ni o_h u_l
拘	jv v_h v_h
拙	zhu o_h o_h
招	qi aa_l o_h
招	zh aa_h o_h
拜	b a_h eh_l
拜	b a_m eh_m
拟	ni i_l i_l
拢	lu u_l ng_l
拣	ji a_l nn_l
拥	yi u_h ng_h
拦	l a_l nn_h
拧	ni el_h ng_l
拧	ni el_l ng_h
拧	ni el_l ng_l
拨	bu o_h o_h
择	z el_l el_h
择	zh a_l eh_h
括	gu a_h a_h
括	ku o_h o_l
拭	sh ib_h ib_l
拮	ji eh_l eh_h
拯	zh el_l ng_l
拱	gu u_l ng_l
拳	qv a_l nn_h
拴	shu a_h nn_h
拷	k aa_l o_l
拼	pi i_h nn_h
拽	yi eh_h eh_l
拽	zhu a_h eh_h
拽	zhu a_h eh_l
拾	sh el_h el_l
拾	sh ib_l ib_h
拾	sh ib_m ib_m
拿	n a_l a_h
持	ch ib_l ib_h
挂	gu a_h a_l
指	zh ib_h ib_h
指	zh ib_l ib_h
指	zh ib_l ib_l
指	zh ib_m ib_m
按	a_h nn_l
挎	ku a_h a_l
挑	ti aa_h o_h
挑	ti aa_l o_l
挑	ti aa_m o_m
挖	wu a_h a_h
挚	zh ib_h ib_l
挛	lu a_l nn_h
挝	wu o_h o_h
挝	zhu a_h a_h
挞	t a_h a_l
挟	ji a_h a_h
挟	xi eh_l eh_h
挠	n aa_l o_h
挠	n aa_m o_m
挡	d aa_h ng_l
挡	d aa_l ng_l
挢	ji aa_l o_l
挣	zh el_h ng_h
挣	zh el_h ng_l
挣	zh el_m ng_m
挤	ji i_l i_l
挥	hu eh_h i_h
挨	a_h eh_h
挨	a_l eh_h
挪	nu o_l o_h
挫	cu o_h o_l
振	zh el_h nn_l
挲	s a_h a_h
挲	sh a_h a_h
挲	su o_h o_h
挹	yi i_h i_l
挺	ti el_l ng_l
挽	wu a_l nn_l
捂	wu u_l u_h
捂	wu u_l u_l
捅	tu u_l ng_l
捆	ku el_l nn_l
捉	zhu o_h o_h
捋	lu o_h o_h
捋	lv v_l v_l
捌	b a_h a_h
捍	h a_h nn_l
捎	sh aa_h o_h
捎	sh aa_h o_l
捏	ni eh_h eh_h
捐	jv a_h nn_h
捕	bu u_l u_l
捞	l aa_h o_h
损	su el_l nn_l
捡	ji a_l nn_l
换	hu a_h nn_l
换	hu a_m nn_m
捣	d aa_l o_l
捣	d aa_m o_m
捧	p el_l ng_l
捭	b a_l eh_l
据	jv v_h v_h
据	jv v_h v_l
捶	chu eh_l i_h
捷	ji eh_l eh_h
捺	n a_h a_l
捻	ni a_l nn_l
掀	xi a_h nn_h
掂	di a_h nn_h
掇	du o_h o_h
掇	du o_m o_m
授	sh o_h u_l
掉	di aa_h o_l
掌	zh aa_l ng_l
掏	t aa_h o_h
掏	t aa_l o_h
掐	qi a_h a_h
排	p a_l eh_h
排	p a_l eh_l
掖	yi eh_h eh_h
掖	yi eh_h eh_l
掘	jv eh_l eh_h
掠	lv eh_h eh_l
掠	lv eh_l eh_l
探	t a_h nn_l
掣	ch el_h el_l
接	ji eh_h eh_h
控	ku u_h ng_l
推	tu eh_h i_h
掩	yi a_l nn_l
措	cu o_h o_l
掬	jv v_h v_h
掭	ti a_h nn_l
掰	b a_h eh_h
掰	bu o_h o_l
掷	zh ib_h ib_l
掸	d a_l nn_l
掸	sh a_h nn_l
掺	c a_h nn_l
掺	ch a_h nn_h
掺	sh a_l nn_l
掺	xi a_h nn_h
掼	gu a_h nn_l
掾	yv a_h nn_l
揆	ku eh_l i_h
揉	r o_l u_h
描	mi aa_l o_h
提	di i_h i_h
提	ti i_l i_h
插	ch a_h a_h
揖	yi i_h i_h
握	wu o_h o_l
揣	chu a_h eh_h
揣	chu a_h eh_l
揣	chu a_l eh_l
揣	tu a_l nn_h
揣	zhu eh_h i_h
揩	k a_h eh_h
揪	ji o_h u_h
揭	ji eh_h eh_h
揲	di eh_l eh_h
揲	sh el_l el_h
援	yv a_l nn_h
揶	yi eh_l eh_h
揸	zh a_h a_h
揽	l a_l nn_l
揽	l a_m nn_m
搁	g el_h el_h
搁	g el_l el_h
搁	g el_m el_m
搂	l o_h u_h
搂	l o_l u_l
搂	l o_m u_m
搅	ji aa_l o_l
搋	chu a_h eh_h
搌	zh a_l nn_l
搏	bu o_l o_h
搓	cu o_h o_h
搜	s o_h u_h
搞	g aa_l o_l
搪	t aa_l ng_h
搬	b a_h nn_h
搭	d a_h a_h
搭	d a_m a_m
携	xi eh_l eh_h
搽	ch a_l a_h
摄	sh el_h el_l
摅	shu u_h u_h
摆	b a_l eh_l
摇	yi aa_l o_h
摊	t a_h nn_h
摔	shu a_h eh_h
摘	zh a_h eh_h
摞	lu o_h o_l
摧	cu eh_h i_h
摩	m a_h a_h
摩	mu o_l o_h
摸	mu o_h o_h
摸	mu o_m o_m
摹	mu o_l o_h
摺	l a_h a_h
摺	zh el_l el_h
撂	li aa_h o_l
撄	yi el_h ng_h
撅	jv eh_h eh_h
撅	jv eh_h eh_l
撇	pi eh_h eh_h
撇	pi eh_l eh_l
撑	ch el_h ng_h
撒	s a_h a_h
撒	s a_l a_l
撒	s a_m a_m
撕	s if_h if_h
撖	h a_h nn_l
撙	zu el_l nn_l
撞	zhu aa_h ng_l
撤	ch el_h el_l
撩	li aa_h o_h
撩	li aa_h o_l
撩	li aa_l o_h
撬	qi aa_h o_l
播	bu o_h o_h
撮	cu o_h o_h
撮	zu o_l o_l
撰	zhu a_h nn_l
撵	ni a_l nn_l
撷	xi eh_l eh_h
撸	lu u_h u_h
撺	cu a_h nn_h
撼	h a_h nn_l
擀	g a_l nn_l
擂	l eh_h i_l
擂	l eh_l i_h
擅	sh a_h nn_l
操	c aa_h o_h
擎	qi el_l ng_h
擐	hu a_h nn_l
擒	qi i_l nn_h
擗	bu o_h o_l
擗	pi i_l i_l
擘	bu o_h o_l
擢	zhu o_l o_h
擤	xi el_l ng_l
擦	c a_h a_h
攀	p a_h nn_h
攒	cu a_l nn_h
攒	z a_l nn_l
攘	r aa_l ng_l
支	zh ib_h ib_h
攴	pu o_h o_h
攴	pu u_h u_h
收	sh o_h u_h
攸	yi o_h u_h
改	g a_l eh_l
攻	gu u_h ng_h
放	f aa_h ng_l
政	zh el_h ng_l
故	gu u_h u_l
效	xi aa_h o_l
敉	mi i_l i_l
敌	di i_l i_h
敏	mi i_l nn_l
救	ji o_h u_l
敕	ch ib_h ib_l
敖	aa_l o_h
教	ji aa_h o_h
教	ji aa_h o_l
敛	li a_l nn_l
敝	bi i_h i_l
敞	ch aa_l ng_l
敢	g a_l nn_l
散	s a_h nn_l
散	s a_l nn_l
散	s a_m nn_m
敦	du eh_h i_l
敦	du el_h nn_h
敬	ji el_h ng_l
数	shu o_h o_l
数	shu u_h u_l
数	shu u_l u_l
数	shu u_m u_m
敲	qi aa_h o_h
整	zh el_l ng_l
敷	fu u_h u_h
文	wu el_l nn_h
斋	zh a_h eh_h
斌	bi i_h nn_h
斐	f eh_l i_l
斑	b a_h nn_h
斓	l a_l nn_h
斗	d o_h u_l
斗	d o_l u_l
斗	d o_m u_m
料	li aa_h o_l
料	li aa_m o_m
斛	hu u_l u_h
斜	xi eh_l eh_h
斜	xi eh_m eh_m
斟	zh el_h nn_h
斡	wu o_h o_l
斤	ji i_h nn_h
斥	ch ib_h ib_l
斧	fu u_l u_l
斩	zh a_h nn_l
斩	zh a_l nn_l
斫	zhu o_l o_h
断	du a_h nn_l
斯	s if_h if_h
新	xi i_h nn_h
方	f aa_h ng_h
於	wu u_h u_h
於	yv v_h v_h
於	yv v_l v_h
施	sh ib_h ib_h
旁	p aa_l ng_h
旃	zh a_h nn_h
旄	m aa_l o_h
旅	lv v_l v_l
旋	xv a_h nn_l
旋	xv a_l nn_h
旌	ji el_h ng_h
旎	ni i_l i_l
族	zu u_l u_h
旖	yi i_l i_l
旗	qi i_l i_h
无	mu o_l o_h
无	wu u_l u_h
既	ji i_h i_l
日	r ib_h ib_l
日	r ib_m ib_m
旦	d a_h nn_l
旧	ji o_h u_l
旨	zh ib_l ib_l
早	z aa_l o_l
旬	xv el_l nn_h
旭	xv v_h v_l
旮	g a_h a_h
旯	l a_l a_h
旰	g a_h nn_l
旱	h a_h nn_l
时	sh ib_l ib_h
旷	ku aa_h ng_l
旺	wu aa_h ng_l
昀	yv el_l nn_h
昂	aa_l ng_h
昃	z el_h el_l
昆	ku el_h nn_h
昊	h aa_h o_l
昌	ch aa_h ng_h
明	mi el_l ng_h
昏	hu el_h nn_h
易	yi i_h i_l
昔	xi i_h i_h
昕	xi i_h nn_h
昙	t a_l nn_h
昝	z a_l nn_l
星	xi el_h ng_h
映	yi el_h ng_l
春	chu el_h nn_h
昧	m eh_h i_l
昨	zu o_l o_h
昭	zh aa_h o_h
是	sh ib_h ib_l
是	sh ib_m ib_m
昱	yv v_h v_l
昴	m aa_l o_l
昵	ni i_h i_l
昶	ch aa_l ng_l
昼	zh o_h u_l
显	xi a_l nn_l
晁	ch aa_l o_h
晃	hu aa_h ng_h
晃	hu aa_h ng_l
晃	hu aa_l ng_l
晋	ji i_h nn_l
晌	sh aa_l ng_l
晏	yi a_h nn_l
晒	sh a_h eh_l
晓	xi aa_l o_l
晔	yi eh_h eh_l
晕	yv el_h nn_h
晕	yv el_h nn_l
晖	hu eh_h i_h
晗	h a_l nn_h
晚	wu a_l nn_l
晟	ch el_l ng_h
晟	sh el_h ng_l
晤	wu u_h u_l
晦	hu eh_h i_l
晦	hu eh_m i_m
晨	ch el_l nn_h
普	pu u_l u_l
景	ji el_l ng_l
晰	xi i_h i_h
晴	qi el_l ng_h
晶	ji el_h ng_h
晷	gu eh_l i_l
智	zh ib_h ib_l
晾	li aa_h ng_l
暂	z a_h nn_l
暄	xv a_h nn_h
暇	xi a_l a_h
暑	shu u_l u_l
暖	nu a_l nn_l
暗	a_h nn_l
暧	a_h eh_l
暨	ji i_h i_l
暮	mu u_h u_l
暴	b aa_h o_l
暴	pu u_h u_l
暹	xi a_h nn_h
暾	tu el_h nn_h
曙	shu u_l u_l
曜	yi aa_h o_l
曝	b aa_h o_l
曝	pu u_h u_l
曦	xi i_h i_h
曩	n aa_l ng_l
曰	yv eh_h eh_h
曲	qv v_h v_h
曲	qv v_l v_l
曳	yi eh_h eh_l
更	g el_h ng_h
更	g el_h ng_l
曹	c aa_l o_h
曼	m a_h nn_l
曾	c el_l ng_h
曾	z el_h ng_h
替	ti i_h i_l
最	zu eh_h i_l
月	yv eh_h eh_l
有	yi o_h u_l
有	yi o_l u_l
朋	p el_l ng_h
服	fu u_h u_l
服	fu u_l u_h
服	fu u_m u_m
朐	qv v_l v_h
朔	shu o_h o_l
朕	zh el_h nn_l
朗	l aa_l ng_l
望	wu aa_h ng_l
朝	ch aa_l o_h
朝	zh aa_h o_h
期	ji i_h i_h
期	qi i_h i_h
朦	m el_l ng_h
木	mu u_h u_l
未	wu eh_h i_l
末	mu o_h o_l
末	mu o_m o_m
本	b el_l nn_l
札	zh a_l a_h
术	shu u_h u_l
术	zhu u_l u_h
朱	zhu u_h u_h
朴	pi aa_l o_h
朴	pu o_h o_h
朴	pu o_h o_l
朴	pu u_l u_l
朵	du o_l o_l
朵	du o_m o_m
机	ji i_h i_h
朽	xi o_l u_l
杀	sh a_h a_h
杂	z a_l a_h
权	qv a_l nn_h
杆	g a_h nn_h
杆	g a_l nn_l
杈	ch a_h a_h
杈	ch a_h a_l
杉	sh a_h a_h
杉	sh a_h nn_h
杌	wu u_h u_l
李	li i_l i_l
李	li i_m i_m
杏	xi el_h ng_l
材	c a_l eh_h
材	c a_m eh_m
村	cu el_h nn_h
杓	bi aa_h o_h
杓	sh aa_l o_h
杖	zh aa_h ng_l
杜	du u_h u_l
杞	qi i_l i_l
束	shu u_h u_l
杠	g aa_h ng_h
杠	g aa_h ng_l
条	ti aa_l o_h
来	l a_l eh_h
杨	yi aa_l ng_h
杩	m a_h a_l
杩	m a_l a_l
杪	mi aa_l o_l
杭	h aa_l ng_h
杯	b eh_h i_h
杰	ji eh_l eh_h
杲	g aa_l o_l
杳	yi aa_l o_l
杵	chu u_l u_l
杷	p a_l a_h
杼	zhu u_h u_l
松	su u_h ng_h
板	b a_l nn_l
极	ji i_l i_h
构	g o_h u_l
枇	pi i_l i_h
枉	wu aa_l ng_l
枋	f aa_h ng_h
析	xi i_h i_h
枕	zh el_l nn_l
林	li i_l nn_h
枘	ru eh_h i_l
枚	m eh_l i_h
果	gu o_l o_l
枝	zh ib_h ib_h
枞	cu u_h ng_h
枞	zu u_h ng_h
枢	shu u_h u_h
枣	z aa_l o_l
枥	li i_h i_l
枧	ji a_l nn_l
枨	ch el_l ng_h
枪	qi aa_h ng_h
枫	f el_h ng_h
枭	xi aa_h o_h
枯	ku u_h u_h
枰	pi el_l ng_h
枳	zh ib_l ib_l
架	ji a_h a_l
枷	ji a_h a_h
枸	g o_h u_h
枸	g o_l u_l
枸	jv v_l v_l
柁	du o_h o_l
柁	tu o_l o_h
柃	li el_l ng_h
柄	bi el_l ng_l
柏	b a_l eh_l
柏	bu o_h o_l
柏	bu o_l o_h
某	m o_l u_l
柑	g a_h nn_h
柒	qi i_h i_h
染	r a_l nn_l
柔	r o_l u_h
柘	zh el_h el_l
柚	yi o_h u_l
柚	yi o_l u_h
柜	gu eh_h i_l
柜	jv v_l v_l
柞	zh a_h a_l
柞	zu o_h o_l
柠	ni el_l ng_h
查	ch a_l a_h
查	zh a_h a_h
柬	ji a_l nn_l
柯	k el_h el_h
柰	n a_h eh_l
柱	zhu u_h u_l
柳	li o_l u_l
柴	ch a_l eh_h
柽	ch el_h ng_h
柿	sh ib_h ib_l
栀	zh ib_h ib_h
栅	sh a_h nn_h
栅	zh a_h a_l
标	bi aa_h o_h
栈	zh a_h nn_l
栈	zh a_l nn_l
栉	zh ib_h ib_l
栊	lu u_l ng_h
栋	du u_h ng_l
栌	lu u_l u_h
栎	li i_h i_l
栎	yv eh_h eh_l
栏	l a_l nn_h
栏	l a_m nn_m
树	shu u_h u_l
栓	shu a_h nn_h
栖	qi i_h i_h
栖	xi i_h i_h
栗	li i_h i_l
栝	gu a_h a_h
栝	ku o_h o_l
校	ji aa_h o_l
校	xi aa_h o_l
栩	xv v_l v_l
株	zhu u_h u_h
栲	k aa_l o_l
栳	l aa_l o_l
样	yi aa_h ng_l
核	h el_l el_h
核	hu u_l u_h
根	g el_h nn_h
格	g el_h el_h
格	g el_l el_h
栽	z a_h eh_h
栾	lu a_l nn_h
桀	ji eh_l eh_h
桁	h el_l ng_h
桂	gu eh_h i_l
桃	t aa_l o_h
桃	t aa_m o_m
桄	gu aa_h ng_h
桄	gu aa_h ng_l
桅	wu eh_l i_h
框	ku aa_h ng_h
框	ku aa_h ng_l
框	ku aa_m ng_m
案	a_h nn_l
桉	a_h nn_h
桊	jv a_h nn_l
桌	zhu o_h o_h
桎	zh ib_h ib_l
桐	tu u_l ng_h
桑	s aa_h ng_h
桓	hu a_l nn_h
桔	ji eh_l eh_h
桔	jv v_l v_h
桕	ji o_h u_l
桠	yi a_h a_h
桡	r aa_l o_h
桢	zh el_h nn_h
档	d aa_h ng_h
档	d aa_h ng_l
档	d aa_l ng_l
桤	qi i_h i_h
桥	qi aa_l o_h
桦	hu a_h a_l
桧	gu eh_h i_l
桧	hu eh_h i_l
桨	ji aa_l ng_l
桩	zhu aa_h ng_h
桫	su o_h o_h
桴	fu u_l u_h
桶	tu u_l ng_l
桷	jv eh_l eh_h
梁	li aa_l ng_h
梁	li aa_m ng_m
梃	ti el_h ng_l
梃	ti el_l ng_l
梅	m eh_l i_h
梆	b aa_h ng_h
梏	gu u_h u_l
梓	z if_l if_l
梗	g el_l ng_l
梢	s aa_h o_l
梢	sh aa_h o_h
梦	m el_h ng_l
梧	wu u_l u_h
梨	li i_l i_h
梭	su o_h o_h
梯	ti i_h i_h
械	xi eh_h eh_l
梳	shu u_h u_h
梵	f a_h nn_l
检	ji a_l nn_l
棂	li el_l ng_h
棉	mi a_l nn_h
棋	qi i_l i_h
棍	gu el_h nn_l
棒	b aa_h ng_l
棕	zu u_h ng_h
棘	ji i_l i_h
棚	p el_l ng_h
棠	t aa_l ng_h
棣	di i_h i_l
森	s el_h nn_h
棰	chu eh_l i_h
棱	l el_h ng_h
棱	l el_l ng_h
棱	l el_m ng_m
棱	li el_l ng_h
棵	k el_h el_h
棹	zh aa_h o_l
棺	gu a_h nn_h
棼	f el_l nn_h
椁	gu o_l o_l
椅	yi i_h i_h
椅	yi i_l i_l
椋	li aa_l ng_h
植	zh ib_l ib_h
椎	chu eh_l i_h
椎	zhu eh_h i_h
椒	ji aa_h o_h
椟	du u_l u_h
椠	qi a_h nn_l
椤	lu o_l o_h
椭	tu o_l o_l
椰	yi eh_h eh_h
椴	du a_h nn_l
椹	sh el_h nn_l
椹	zh el_h nn_h
椽	chu a_l nn_h
椿	chu el_h nn_h
楂	ch a_l a_h
楂	zh a_h a_h
楔	xi eh_h eh_h
楗	ji a_h nn_l
楚	chu u_l u_l
楝	li a_h nn_l
楞	l el_l ng_h
楞	l el_m ng_m
楠	n a_l nn_h
楣	m eh_l i_h
楦	xv a_h nn_l
楫	ji i_l i_h
楮	chu u_l u_l
楷	ji eh_h eh_h
楷	k a_l eh_l
楸	qi o_h u_h
楹	yi el_l ng_h
楼	l o_l u_h
榀	pi i_l nn_l
概	g a_h eh_l
榄	l a_l nn_l
榆	yv v_l v_h
榈	lv v_l v_h
榉	jv v_l v_l
榍	xi eh_h eh_l
榔	l aa_l ng_h
榕	ru u_l ng_h
榘	jv v_l v_l
榛	zh el_h nn_h
榜	b aa_l ng_l
榧	f eh_l i_l
榨	zh a_h a_l
榫	su el_l nn_l
榭	xi eh_h eh_l
榴	li o_l u_h
榴	li o_m u_m
榷	qv eh_h eh_l
榻	t a_h a_l
槁	g aa_l o_l
槊	shu o_h o_l
槌	chu eh_l i_h
槎	ch a_l a_h
槐	hu a_l eh_h
槛	ji a_h nn_l
槛	k a_l nn_l
槟	bi el_h ng_h
槟	bi i_h nn_h
槠	zhu u_h u_h
槭	qi i_h i_l
槭	s el_h el_l
槲	hu u_l u_h
槽	c aa_l o_h
槿	ji i_l nn_l
樊	f a_l nn_h
樗	chu u_h u_h
樘	t aa_l ng_h
樟	zh aa_h ng_h
模	mu o_l o_h
模	mu o_m o_m
模	mu u_l u_h
樨	xi i_h i_h
横	h el_h ng_l
横	h el_l ng_h
樯	qi aa_l ng_h
樱	yi el_h ng_h
樵	qi aa_l o_h
樽	zu el_h nn_h
樾	yv eh_h eh_l
橄	g a_l nn_l
橇	qi aa_h o_h
橘	jv v_l v_h
橙	ch el_l ng_h
橛	jv eh_l eh_h
橡	xi aa_h ng_l
橥	zhu u_h u_h
橱	chu u_l u_h
橹	lu u_l u_l
橼	yv a_l nn_h
檀	t a_l nn_h
檎	qi i_l nn_h
檐	yi a_l nn_h
檑	l eh_l i_h
檗	bu o_h o_l
檗	ni eh_h eh_l
檩	li i_l nn_l
檫	ch a_l a_h
檬	m el_l ng_h
欠	qi a_h nn_l
欠	qi a_m nn_m
次	c if_h if_l
欢	hu a_h nn_h
欢	hu a_m nn_m
欣	xi i_h nn_h
欧	o_h u_h
欲	yv v_h v_l
欺	qi i_h i_h
款	ku a_l nn_l
歆	xi i_h nn_h
歇	xi eh_h eh_h
歉	qi a_h nn_l
歌	g el_h el_h
歌	g el_m el_m
歙	sh el_h el_l
歙	xi i_h i_h
止	zh ib_l ib_l
正	zh el_h ng_h
正	zh el_h ng_l
此	c if_l if_l
步	bu u_h u_l
武	wu u_l u_l
歧	qi i_l i_h
歪	wu a_h eh_h
歪	wu a_m eh_m
歹	d a_l eh_l
死	s if_l if_l
歼	ji a_h nn_h
殁	mu o_h o_l
殃	yi aa_h ng_h
殄	ti a_l nn_l
殆	d a_h eh_l
殇	sh aa_h ng_h
殉	xv el_h nn_l
殊	shu u_h u_h
残	c a_l nn_h
殓	li a_h nn_l
殖	sh ib_m ib_m
殖	zh ib_l ib_h
殡	bi i_h nn_l
殪	yi i_h i_l
殳	shu u_h u_h
殴	o_h u_h
段	du a_h nn_l
殷	yi a_h nn_h
殷	yi i_h nn_h
殷	yi i_l nn_l
殿	di a_h nn_l
毁	hu eh_l i_l
毂	gu u_h u_h
毂	gu u_l u_l
毅	yi i_h i_l
毋	wu u_l u_h
母	mu u_l u_l
母	mu u_m u_m
每	m eh_l i_l
毒	du u_l u_h
毓	yv v_h v_l
比	bi i_l i_l
毕	bi i_h i_l
毗	pi i_l i_h
毛	m aa_l o_h
毛	m aa_m o_m
毡	zh a_h nn_h
毪	mu u_l u_h
毫	h aa_l o_h
毯	t a_l nn_l
毳	cu eh_h i_l
毹	shu u_h u_h
毽	ji a_h nn_l
氆	pu u_l u_l
氇	lu u_h u_h
氇	lu u_l u_l
氇	lu u_m u_m
氍	qv v_l v_h
氏	sh ib_h ib_l
氏	zh ib_h ib_h
氐	di i_h i_h
氐	di i_l i_l
民	mi i_l nn_h
氓	m aa_l ng_h
氓	m el_l ng_h
气	qi i_h i_l
气	qi i_m i_m
氙	xi a_h nn_h
氛	f el_h nn_h
氟	fu u_l u_h
氡	du u_h ng_h
氢	qi el_h ng_h
氦	h a_h eh_l
氧	yi aa_l ng_l
氨	a_h nn_h
氩	yi a_h a_l
氪	k el_h el_l
氮	d a_h nn_l
氯	lv v_h v_l
氰	qi el_l ng_h
水	shu eh_l i_l
水	shu eh_m i_m
永	yi u_l ng_l
氽	tu el_l nn_l
汀	ti el_h ng_h
汁	zh ib_h ib_h
求	qi o_l u_h
汆	cu a_h nn_h
汇	hu eh_h i_l
汉	h a_h nn_l
汊	ch a_h a_l
汐	xi i_h i_h
汔	qi i_h i_l
汕	sh a_h nn_l
汗	h a_h nn_l
汗	h a_l nn_h
汛	xv el_h nn_l
汜	s if_h if_l
汝	ru u_l u_l
汞	gu u_l ng_l
江	ji aa_h ng_h
池	ch ib_l ib_h
污	wu u_h u_h
汤	sh aa_h ng_h
汤	t aa_h ng_h
汨	mi i_h i_l
汩	gu u_l u_l
汪	wu aa_h ng_h
汰	t a_h eh_l
汰	t a_m eh_m
汲	ji i_l i_h
汴	bi a_h nn_l
汶	wu el_h nn_l
汹	xv u_h ng_h
汽	qi i_h i_l
汾	f el_l nn_h
沁	qi i_h nn_l
沂	yi i_l i_h
沃	wu o_h o_l
沅	yv a_l nn_h
沆	h aa_h ng_l
沈	sh el_l nn_l
沉	ch el_l nn_h
沌	du el_h nn_l
沌	zhu a_h nn_l
沏	qi i_h i_h
沐	mu u_h u_l
沓	d a_l a_h
沓	t a_h a_l
沔	mi a_l nn_l
沙	sh a_h a_h
沙	sh a_h a_l
沛	p eh_h i_l
沟	g o_h u_h
没	m eh_l i_h
没	m eh_m i_m
没	mu o_h o_l
沣	f el_h ng_h
沤	o_h u_h
沤	o_h u_l
沥	li i_h i_l
沦	lu el_l nn_h
沧	c aa_h ng_h
沩	wu eh_l i_h
沪	hu u_h u_l
沫	mu o_h o_l
沫	mu o_m o_m
沭	shu u_h u_l
沮	jv v_h v_l
沮	jv v_l v_l
沱	du o_h o_l
沱	tu o_l o_h
河	h el_l el_h
沸	f eh_h i_l
油	yi o_h u_h
油	yi o_l u_h
治	zh ib_h ib_l
沼	zh aa_l o_l
沽	gu u_h u_h
沾	zh a_h nn_h
沿	yi a_l nn_h
泄	xi eh_h eh_l
泅	qi o_l u_h
泉	qv a_l nn_h
泊	bu o_l o_h
泊	pu o_h o_h
泌	bi i_h i_l
泌	mi i_h i_l
泐	l el_h el_l
泓	hu u_l ng_h
泔	g a_h nn_h
法	f a_l a_l
法	f a_m a_m
泖	m aa_l o_l
泗	s if_h if_l
泛	f a_h nn_l
泛	f a_l nn_h
泛	f a_m nn_m
泞	ni el_h ng_l
泠	li el_l ng_h
泡	p aa_h o_h
泡	p aa_h o_l
泡	p aa_m o_m
波	bu o_h o_h
泣	qi i_h i_l
泥	ni i_h i_l
泥	ni i_l i_h
注	zhu u_h u_l
泪	l eh_h i_l
泫	xv a_h nn_l
泮	p a_h nn_l
泯	mi i_l nn_l
泰	t a_h eh_l
泱	yi aa_h ng_h
泳	yi u_l ng_l
泵	b el_h ng_l
泷	lu u_l ng_h
泷	shu aa_h ng_h
泸	lu u_l u_h
泺	lu o_h o_l
泺	pu o_h o_h
泻	xi eh_h eh_l
泼	pu o_h o_h
泽	z el_l el_h
泾	ji el_h ng_h
洁	ji eh_l eh_h
洄	hu eh_l i_h
洇	yi i_h nn_h
洋	xi aa_l ng_h
洋	yi aa_h ng_h
洋	yi aa_l ng_h
洌	li eh_h eh_l
洎	ji i_h i_l
洒	s a_l a_l
洗	xi a_l nn_l
洗	xi i_l i_l
洙	zhu u_h u_h
洚	ji aa_h ng_l
洛	lu o_h o_l
洞	du u_h ng_l
津	ji i_h nn_h
洧	wu eh_l i_l
洪	hu u_l ng_h
洫	xv v_h v_l
洮	t aa_l o_h
洱	er_l er_l
洲	zh o_h u_h
洳	ru u_h u_l
洵	xv el_l nn_h
洹	hu a_l nn_h
活	hu o_l o_h
活	hu o_m o_m
洼	wu a_h a_h
洽	qi a_h a_l
派	p a_h a_h
派	p a_h eh_l
派	p a_m eh_m
流	li o_l u_h
浃	ji a_h a_h
浅	ji a_h nn_h
浅	qi a_l nn_l
浆	ji aa_h ng_h
浆	ji aa_h ng_l
浇	ji aa_h o_h
浈	zh el_h nn_h
浊	zhu o_l o_h
测	c el_h el_l
浍	hu eh_h i_l
浍	ku a_h eh_l
济	ji i_h i_l
济	ji i_l i_l
浏	li o_l u_h
浑	hu el_h nn_l
浑	hu el_l nn_h
浒	hu u_l u_l
浒	xv v_l v_l
浓	nu u_l ng_h
浔	xv el_l nn_h
浙	zh el_h el_l
浚	jv el_h nn_l
浚	xv el_h nn_l
浜	b aa_h ng_h
浞	zhu o_l o_h
浠	xi i_h i_h
浣	hu a_h nn_l
浦	pu u_l u_l
浩	h aa_h o_l
浪	l aa_h ng_l
浪	l aa_m ng_m
浮	fu u_l u_h
浯	wu u_l u_h
浴	yv v_h v_l
海	h a_l eh_l
浸	ji i_h nn_l
涂	tu u_l u_h
涂	tu u_m u_m
涅	ni eh_h eh_l
消	xi aa_h o_h
消	xi aa_m o_m
涉	sh el_h el_l
涌	chu u_h ng_h
涌	yi u_l ng_l
涎	xi a_l nn_h
涑	su u_h u_l
涓	jv a_h nn_h
涔	c el_l nn_h
涕	ti i_h i_l
涛	t aa_h o_h
涝	l aa_h o_l
涝	l aa_l o_h
涞	l a_l eh_h
涟	li a_l nn_h
涠	wu eh_l i_h
涡	gu o_h o_h
涡	wu o_h o_h
涣	hu a_h nn_l
涤	di i_l i_h
润	ru el_h nn_l
涧	ji a_h nn_l
涨	zh aa_h ng_l
涨	zh aa_l ng_l
涩	s el_h el_l
涪	fu u_l u_h
涫	gu a_h nn_h
涫	gu a_h nn_l
涮	shu a_h nn_l
涯	yi a_l a_h
液	yi eh_h eh_l
涵	h a_l nn_h
涸	h el_l el_h
涿	zhu o_h o_h
淀	di a_h nn_l
淄	z if_h if_h
淅	xi i_h i_h
淆	xi aa_l o_h
淇	qi i_l i_h
淋	li i_h nn_h
淋	li i_h nn_l
淋	li i_l nn_h
淌	t aa_l ng_l
淑	shu u_h u_h
淖	n aa_h o_l
淘	t aa_l o_h
淙	cu u_l ng_h
淝	f eh_l i_h
淞	su u_h ng_h
淠	p eh_h i_l
淠	pi i_h i_l
淡	d a_h nn_l
淤	yv v_h v_h
淦	g a_h nn_l
淫	yi i_l nn_h
淬	cu eh_h i_l
淮	hu a_l eh_h
深	sh el_h nn_h
淳	chu el_l nn_h
混	hu el_h nn_l
混	hu el_l nn_h
混	hu el_m nn_m
淹	yi a_h nn_h
添	ti a_h nn_h
淼	mi aa_l o_l
清	qi el_h ng_h
渊	yv a_h nn_h
渌	lu u_h u_l
渍	z if_h if_l
渎	du u_l u_h
渐	ji a_h nn_h
渐	ji a_h nn_l
渑	mi a_l nn_l
渑	sh el_l ng_h
渔	yv v_l v_h
渗	sh el_h nn_l
渚	zhu u_l u_l
渝	yv v_l v_h
渠	qv v_l v_h
渡	du u_h u_l
渣	zh a_h a_h
渤	bu o_l o_h
渥	wu o_h o_l
温	wu el_h nn_h
渫	xi eh_h eh_l
渭	wu eh_h i_l
港	g aa_l ng_l
渲	xv a_h nn_l
渴	k el_l el_l
游	yi o_l u_h
游	yi o_m u_m
渺	mi aa_l o_l
湃	p a_h eh_l
湄	m eh_l i_h
湍	tu a_h nn_h
湎	mi a_l nn_l
湓	p el_l nn_h
湔	ji a_h nn_h
湖	hu u_l u_h
湘	xi aa_h ng_h
湛	zh a_h nn_l
湟	hu aa_l ng_h
湫	ji aa_l o_l
湫	qi o_h u_h
湮	yi a_h nn_h
湮	yi i_h nn_h
湾	wu a_h nn_h
湿	sh ib_h ib_h
溃	hu eh_h i_l
溃	ku eh_h i_l
溅	ji a_h nn_h
溅	ji a_h nn_l
溆	xv v_h v_l
溉	g a_h eh_l
溏	t aa_l ng_h
源	yv a_l nn_h
溜	li o_h u_h
溜	li o_h u_l
溜	li o_m u_m
溟	mi el_l ng_h
溢	yi i_h i_l
溥	pu u_l u_l
溧	li i_h i_l
溪	xi i_h i_h
溯	su u_h u_l
溱	qi i_l nn_h
溱	zh el_h nn_h
溴	xi o_h u_l
溶	ru u_l ng_h
溷	hu el_h nn_l
溺	ni aa_h o_l
溺	ni i_h i_l
滁	chu u_l u_h
滂	p aa_h ng_h
滇	di a_h nn_h
滋	z if_h if_h
滏	fu u_l u_l
滑	hu a_l a_h
滓	z if_l if_l
滓	z if_m if_m
滔	t aa_h o_h
滕	t el_l ng_h
滚	gu el_l nn_l
滞	zh ib_h ib_l
滟	yi a_h nn_l
滠	sh el_h el_l
满	m a_l nn_l
滢	yi el_h ng_l
滢	yi el_l ng_h
滤	lv v_h v_l
滥	l a_h nn_l
滦	lu a_l nn_h
滨	bi i_h nn_h
滩	t a_h nn_h
滴	di i_h i_h
滴	di i_m i_m
滹	hu u_h u_h
漂	pi aa_h o_h
漂	pi aa_h o_l
漂	pi aa_l o_l
漆	qi i_h i_h
漉	lu u_h u_h
漉	lu u_h u_l
漏	l o_h u_l
漓	li i_l i_h
演	yi a_l nn_l
漕	c aa_l o_h
漠	mu o_h o_l
漤	l a_l nn_l
漩	xv a_l nn_h
漪	yi i_h i_h
漫	m a_h nn_l
漭	m aa_l ng_l
漯	lu o_h o_l
漯	t a_h a_l
漱	shu u_h u_l
漳	zh aa_h ng_h
漶	hu a_h nn_l
漾	yi aa_h ng_l
潆	yi el_l ng_h
潇	xi aa_h o_h
潋	li a_h nn_l
潍	wu eh_l i_h
潘	p a_h nn_h
潜	qi a_l nn_h
潞	lu u_h u_l
潢	hu aa_l ng_h
潦	l aa_l o_l
潦	li aa_l o_h
潭	t a_l nn_h
潮	ch aa_l o_h
潲	sh aa_h o_l
潴	zhu u_h u_h
潺	ch a_l nn_h
潼	tu u_l ng_h
澄	ch el_l ng_h
澄	d el_h ng_h
澄	d el_h ng_l
澈	ch el_h el_l
澉	g a_l nn_l
澌	s if_h if_h
澍	shu u_h u_l
澎	p el_h ng_h
澎	p el_l ng_h
澜	l a_l nn_h
澡	z aa_l o_l
澧	li i_l i_l
澳	aa_h o_l
澶	ch a_l nn_h
澹	d a_h nn_l
澹	t a_l nn_h
激	ji i_h i_h
濂	li a_l nn_h
濉	su eh_h i_h
濑	l a_h eh_l
濒	bi i_h nn_h
濞	bi i_h i_l
濠	h aa_l o_h
濡	ru u_l u_h
濮	pu u_l u_h
濯	zhu o_l o_h
瀑	b aa_h o_l
瀑	pu u_h u_l
瀚	h a_h nn_l
瀛	yi el_l ng_h
瀣	xi eh_h eh_l
瀹	yv eh_h eh_l
灌	gu a_h nn_l
灏	h aa_h o_l
灞	b a_h a_l
火	hu o_l o_l
灭	mi eh_h eh_l
灯	d el_h ng_h
灰	hu eh_h i_h
灵	li el_l ng_h
灵	li el_m ng_m
灶	z aa_h o_l
灸	ji o_l u_l
灼	zhu o_l o_h
灾	z a_h eh_h
灿	c a_h nn_l
炀	yi aa_l ng_h
炅	gu eh_h i_l
炅	jv u_l ng_l
炉	lu u_l u_h
炊	chu eh_h i_h
炎	yi a_l nn_h
炒	ch aa_l o_l
炔	gu eh_h i_l
炔	qv eh_h eh_h
炕	k aa_h ng_l
炖	du el_h nn_l
炙	zh ib_h ib_l
炜	wu eh_l i_l
炝	qi aa_h ng_l
炫	xv a_h nn_l
炬	jv v_h v_l
炭	t a_h nn_l
炮	b aa_h o_h
炮	p aa_h o_l
炮	p aa_l o_h
炯	jv u_l ng_l
炳	bi el_l ng_l
炷	zhu u_h u_l
炸	zh a_h a_l
炸	zh a_l a_h
点	di a_l nn_l
点	di a_m nn_m
炻	sh ib_l ib_h
炼	li a_h nn_l
炽	ch ib_h ib_l
烀	hu u_h u_h
烁	shu o_h o_l
烂	l a_h nn_l
烃	ti el_h ng_h
烈	li eh_h eh_l
烊	yi aa_h ng_l
烊	yi aa_l ng_h
烘	hu u_h ng_h
烙	l aa_h o_l
烙	lu o_h o_l
烛	zhu u_l u_h
烟	yi a_h nn_h
烟	yi i_h nn_h
烤	k aa_l o_l
烦	f a_l nn_h
烦	f a_m nn_m
烧	sh aa_h o_h
烨	yi eh_h eh_l
烩	hu eh_h i_l
烫	t aa_h ng_l
烫	t aa_m ng_m
烬	ji i_h nn_l
热	r el_h el_l
烯	xi i_h i_h
烷	wu a_l nn_h
烹	p el_h ng_h
烽	f el_h ng_h
焉	yi a_h nn_h
焊	h a_h nn_l
焐	wu u_h u_l
焓	h a_l nn_h
焕	hu a_h nn_l
焖	m el_h nn_l
焘	d aa_h o_l
焘	t aa_h o_h
焙	b eh_h i_l
焚	f el_l nn_h
焦	ji aa_h o_h
焯	ch aa_h o_h
焯	zhu o_h o_h
焰	yi a_h nn_l
焱	yi a_h nn_l
然	r a_l nn_h
煅	du a_h nn_l
煊	xv a_h nn_h
煌	hu aa_h ng_h
煌	hu aa_l ng_h
煎	ji a_h nn_h
煜	yv v_h v_l
煞	sh a_h a_h
煞	sh a_h a_l
煤	m eh_l i_h
煦	xv v_h v_l
照	zh aa_h o_l
煨	wu eh_h i_h
煨	yv v_h v_l
煮	zhu u_l u_l
煲	b aa_h o_h
煳	hu u_l u_h
煸	bi a_h nn_h
煽	sh a_h nn_h
熄	xi i_h i_h
熊	xv u_l ng_h
熏	xv el_h nn_h
熏	xv el_h nn_l
熔	ru u_l ng_h
熘	li o_h u_h
熙	xi i_h i_h
熙	yi i_l i_h
熟	sh o_l u_h
熟	shu u_l u_h
熠	yi i_h i_l
熨	yv el_h nn_l
熨	yv v_h v_l
熬	aa_h o_h
熬	aa_l o_h
熳	m a_h nn_l
熵	sh aa_h ng_h
熹	xi i_h i_h
燃	r a_l nn_h
燎	li aa_l o_h
燎	li aa_l o_l
燔	f a_l nn_h
燕	yi a_h nn_h
燕	yi a_h nn_l
燠	yv v_h v_l
燥	z aa_h o_l
燧	su eh_h i_l
燮	xi eh_h eh_l
燹	xi a_l nn_l
爆	b aa_h o_l
爝	jv eh_l eh_h
爨	cu a_h nn_l
爪	zh aa_l o_l
爪	zhu a_l a_l
爬	p a_l a_h
爰	yv a_l nn_h
爱	a_h eh_l
爵	jv eh_l eh_h
父	fu u_h u_l
父	fu u_l u_l
父	fu u_m u_m
爷	yi eh_l eh_h
爷	yi eh_m eh_m
爸	b a_h a_l
爸	b a_m a_m
爹	di eh_h eh_h
爻	yi aa_l o_h
爽	shu aa_l ng_l
爿	p a_l nn_h
片	pi a_h nn_h
片	pi a_h nn_l
版	b a_l nn_l
牌	p a_l eh_h
牍	du u_l u_h
牒	di eh_l eh_h
牙	yi a_l a_h
牛	ni o_l u_h
牝	pi i_h nn_l
牟	m o_l u_h
牟	mu u_h u_l
牡	mu u_l u_l
牢	l aa_l o_h
牦	m aa_l o_h
牧	mu u_h u_l
物	wu u_h u_l
牮	ji a_h nn_l
牯	gu u_l u_l
牲	sh el_h ng_h
牵	qi a_h nn_h
特	t el_h el_l
牺	xi i_h i_h
牾	wu u_l u_l
犀	xi i_h i_h
犁	li i_l i_h
犄	ji i_h i_h
犊	du u_l u_h
犋	jv v_h v_l
犍	ji a_h nn_h
犍	qi a_l nn_h
犟	ji aa_h ng_l
犬	qv a_l nn_l
犯	f a_h nn_l
状	zhu aa_h ng_l
犸	m a_l a_l
犹	yi o_l u_h
狁	yv el_l nn_l
狂	ku aa_l ng_h
狄	di i_l i_h
狍	p aa_l o_h
狎	xi a_l a_h
狐	hu u_l u_h
狒	f eh_h i_l
狗	g o_l u_l
狙	jv v_h v_h
狠	h el_l nn_l
狡	ji aa_l o_l
狩	sh o_h u_l
独	du u_l u_h
狭	xi a_l a_h
狮	sh ib_h ib_h
狯	ku a_h eh_l
狱	yv v_h v_l
狲	su el_h nn_h
狸	li i_l i_h
狸	li i_m i_m
狺	yi i_l nn_h
狻	jv el_h nn_l
狻	su a_h nn_h
狼	l aa_l ng_h
猁	li i_h i_l
猃	xi a_l nn_l
猊	ni i_l i_h
猎	li eh_h eh_l
猕	mi i_l i_h
猖	ch aa_h ng_h
猗	yi i_h i_h
猛	m el_l ng_l
猜	c a_h eh_h
猞	sh el_h el_h
猡	lu o_l o_h
猢	hu u_l u_h
猩	xi el_h ng_h
猩	xi el_m ng_m
猪	zhu u_h u_h
猫	m aa_h o_h
猫	m aa_l o_h
猬	wu eh_h i_l
猬	wu eh_m i_m
献	su o_h o_h
献	xi a_h nn_l
猱	n aa_l o_h
猴	h o_l u_h
猷	yi o_l u_h
猹	ch a_l a_h
猿	yv a_l nn_h
獍	ji el_h ng_l
獐	zh aa_h ng_h
獒	aa_l o_h
獗	jv eh_l eh_h
獠	li aa_l o_h
獬	xi eh_h eh_l
獭	t a_l a_l
獯	xv el_h nn_h
獾	hu a_h nn_h
玄	xv a_l nn_h
率	lv v_h v_l
率	shu a_h eh_l
玉	yv v_h v_l
王	wu aa_h ng_l
王	wu aa_l ng_h
王	wu aa_m ng_m
玎	di el_h ng_h
玑	ji i_h i_h
玖	ji o_l u_l
玛	m a_l a_l
玟	mi i_l nn_h
玟	wu el_l nn_h
玢	bi i_h nn_h
玢	f el_h nn_h
玩	wu a_l nn_h
玫	m eh_l i_h
玮	wu eh_l i_l
环	hu a_l nn_h
现	xi a_h nn_l
玲	li el_l ng_h
玳	d a_h eh_l
玷	di a_h nn_l
玺	xi i_l i_l
玻	bu o_h o_h
珀	pu o_h o_l
珂	k el_h el_h
珈	ji a_h a_h
珉	mi i_l nn_h
珊	sh a_h nn_h
珍	zh el_h nn_h
珏	jv eh_l eh_h
珐	f a_h a_l
珑	lu u_l ng_h
珙	gu u_l ng_l
珞	lu o_h o_l
珠	zhu u_h u_h
珥	er_l er_l
珧	yi aa_l o_h
珩	h el_l ng_h
班	b a_h nn_h
珲	hu eh_h i_h
珲	hu el_l nn_h
球	qi o_l u_h
琅	l aa_l ng_h
理	li i_l i_l
理	li i_m i_m
琉	li o_l u_h
琊	yi a_l a_h
琏	li a_l nn_l
琐	su o_l o_l
琚	jv v_h v_h
琛	ch el_h nn_h
琢	zhu o_l o_h
琢	zu o_l o_h
琥	hu u_l u_l
琦	qi i_l i_h
琨	ku el_h nn_h
琪	qi i_l i_h
琬	wu a_l nn_l
琮	cu u_l ng_h
琰	yi a_l nn_l
琳	li i_l nn_h
琴	qi i_l nn_h
琵	pi i_l i_h
琶	p a_l a_h
琶	p a_m a_m
琼	qv u_l ng_h
瑁	m aa_h o_l
瑕	xi a_l a_h
瑗	yv a_h nn_l
瑙	n aa_l o_l
瑚	hu u_l u_h
瑛	yi el_h ng_h
瑜	yv v_l v_h
瑞	ru eh_h i_l
瑟	s el_h el_l
瑭	t aa_l ng_h
瑰	gu eh_h i_h
瑰	gu eh_m i_m
瑶	yi aa_l o_h
瑷	a_h eh_l
瑾	ji i_l nn_l
璀	cu eh_l i_l
璁	cu u_h ng_h
璃	li i_l i_h
璃	li i_m i_m
璇	xv a_l nn_h
璋	zh aa_h ng_h
璎	yi el_h ng_h
璐	lu u_h u_l
璜	hu aa_l ng_h
璞	pu u_l u_h
璧	bi i_h i_l
璨	c a_h nn_l
璩	qv v_l v_h
瓒	z a_h nn_l
瓜	gu a_h a_h
瓠	hu u_h u_l
瓢	pi aa_l o_h
瓣	b a_h nn_l
瓦	wu a_h a_l
瓦	wu a_l a_l
瓮	wu el_h ng_l
瓯	o_h u_h
瓴	li el_l ng_h
瓶	pi el_l ng_h
瓷	c if_l if_h
甄	zh el_h nn_h
甍	m el_l ng_h
甏	b el_h ng_l
甑	z el_h ng_l
甓	pi i_h i_l
甘	g a_h nn_h
甚	sh el_h nn_l
甚	sh el_l nn_h
甜	ti a_l nn_h
生	sh el_h ng_h
生	sh el_m ng_m
甥	sh el_h ng_h
用	yi u_h ng_l
甩	shu a_l eh_l
甫	fu u_l u_l
甬	yi u_l ng_l
甭	b el_l ng_h
甯	ni el_h ng_l
甯	ni el_l ng_h
田	ti a_l nn_h
由	yi o_l u_h
甲	ji a_l a_l
甲	ji a_m a_m
申	sh el_h nn_h
电	di a_h nn_l
男	n a_l nn_h
甸	di a_h nn_l
町	di el_h ng_h
町	ti el_l ng_l
画	hu a_h a_l
甾	z a_h eh_h
畅	ch aa_h ng_l
畈	f a_h nn_l
畋	ti a_l nn_h
界	ji eh_h eh_l
畎	qv a_l nn_l
畏	wu eh_h i_l
畔	p a_h nn_l
留	li o_l u_h
畚	b el_l nn_l
畛	zh el_l nn_l
畜	chu u_h u_l
畜	xv v_h v_l
略	lv eh_h eh_l
畦	qi i_l i_h
番	f a_h nn_h
番	p a_h nn_h
畲	sh el_h el_h
畴	ch o_l u_h
畸	ji i_h i_h
畹	wu a_l nn_l
畿	ji i_h i_h
疃	tu a_l nn_l
疆	ji aa_h ng_h
疋	pi i_l i_l
疋	shu u_h u_h
疋	yi a_l a_l
疏	shu u_h u_h
疑	yi i_l i_h
疔	di el_h ng_h
疗	li aa_l o_h
疙	g el_h el_h
疙	g el_m el_m
疚	ji o_h u_l
疝	sh a_h nn_l
疠	li i_h i_l
疡	yi aa_l ng_h
疣	yi o_l u_h
疤	b a_h a_h
疫	yi i_h i_l
疮	chu aa_h ng_h
疯	f el_h ng_h
疱	p aa_h o_l
疲	pi i_l i_h
疳	g a_h nn_h
疸	d a_l nn_l
疸	d a_m a_m
疹	zh el_l nn_l
疼	t el_l ng_h
疾	ji i_l i_h
疾	ji i_m i_m
痂	ji a_h a_h
痃	xv a_l nn_h
痄	zh a_h a_l
病	bi el_h ng_l
病	bi el_m ng_m
症	zh el_h ng_h
症	zh el_h ng_l
痉	ji el_h ng_l
痊	qv a_l nn_h
痍	yi i_l i_h
痒	yi aa_l ng_l
痒	yi aa_m ng_m
痔	zh ib_h ib_l
痕	h el_l nn_h
痖	yi a_l a_l
痘	d o_h u_l
痛	tu u_h ng_l
痞	pi i_l i_l
痢	li i_h i_l
痢	li i_m i_m
痣	zh ib_h ib_l
痤	cu o_l o_h
痦	wu u_h u_l
痧	sh a_h a_h
痨	l aa_l o_h
痪	hu a_h nn_l
痫	xi a_l nn_h
痰	t a_l nn_h
痴	ch ib_h ib_h
痹	bi i_h i_l
痼	gu u_h u_l
痿	wu eh_l i_l
瘀	yv v_h v_h
瘁	cu eh_h i_l
瘃	zhu u_l u_h
瘊	h o_l u_h
瘌	l a_h a_l
瘌	l a_m a_m
瘘	l o_h u_l
瘟	wu el_h nn_h
瘤	li o_l u_h
瘥	ch a_h eh_l
瘥	cu o_l o_h
瘦	sh o_h u_l
瘩	d a_l a_h
瘩	d a_m a_m
瘪	bi eh_h eh_h
瘪	bi eh_l eh_l
瘫	t a_h nn_h
瘭	bi aa_h o_h
瘳	ch o_h u_h
瘵	zh a_h eh_l
瘸	qv eh_l eh_h
瘼	mu o_h o_l
瘾	yi i_l nn_l
癀	hu aa_l ng_h
癌	a_l eh_h
癍	b a_h nn_h
癜	di a_h nn_l
癞	l a_h a_l
癞	l a_h eh_l
癣	xv a_l nn_l
癫	di a_h nn_h
癯	qv v_l v_h
癸	gu eh_l i_l
登	d el_h ng_h
登	d el_m ng_m
白	b a_l eh_h
百	b a_l eh_l
皂	z aa_h o_l
的	d el_m el_m
的	di i_h i_h
的	di i_h i_l
的	di i_l i_h
的	di i_m i_m
皆	ji eh_h eh_h
皇	hu aa_l ng_h
皈	gu eh_h i_h
皋	g aa_h o_h
皎	ji aa_l o_l
皑	a_l eh_h
皓	h aa_h o_l
皖	wu a_l nn_l
皙	xi i_h i_h
皤	pu o_l o_h
皮	pi i_l i_h
皱	zh o_h u_l
皿	mi i_l nn_l
盂	yv v_l v_h
盅	zhu u_h ng_h
盆	p el_l nn_h
盈	yi el_h ng_h
盈	yi el_l ng_h
益	yi i_h i_l
盎	aa_h ng_l
盏	zh a_l nn_l
盐	yi a_h nn_l
盐	yi a_l nn_h
监	ji a_h nn_h
监	ji a_h nn_l
盒	h el_l el_h
盔	ku eh_h i_h
盖	g a_h eh_l
盖	g a_m eh_m
盖	g el_l el_l
盗	d aa_h o_l
盘	p a_l nn_h
盘	p a_m nn_m
盛	ch el_l ng_h
盛	sh el_h ng_l
盟	m el_l ng_h
目	mu u_h u_l
盯	di el_h ng_h
盱	xv v_h v_h
盲	m aa_l ng_h
盲	m aa_m ng_m
直	zh ib_l ib_h
相	xi aa_h ng_h
相	xi aa_h ng_l
相	xi aa_m ng_m
盹	du el_l nn_l
盼	p a_h nn_l
盾	du el_h nn_l
省	sh el_l ng_l
省	sh el_m ng_m
省	xi el_l ng_l
眄	mi a_l nn_l
眉	m eh_l i_h
看	k a_h nn_h
看	k a_h nn_l
看	k a_m nn_m
眍	k o_h u_h
眙	ch ib_h ib_l
眙	yi i_l i_h
真	zh el_h nn_h
眠	mi a_l nn_h
眢	yv a_h nn_h
眨	zh a_l a_l
眩	xv a_h nn_l
眭	su eh_h i_h
眯	mi i_h i_h
眯	mi i_l i_h
眷	jv a_h nn_l
眸	m o_l u_h
眺	ti aa_h o_l
眼	yi a_l nn_l
着	h aa_l o_h
着	zh aa_h o_h
着	zh aa_l o_h
着	zh el_m el_m
着	zhu o_l o_h
着	zhu o_m o_m
睁	zh el_h ng_h
睇	di i_h i_l
睐	l a_h eh_l
睛	ji el_h ng_h
睡	shu eh_h i_l
睢	su eh_h i_h
督	du u_h u_h
督	du u_m u_m
睦	mu u_h u_l
睫	ji eh_l eh_h
睬	c a_l eh_l
睹	du u_l u_l
睿	ru eh_h i_l
瞀	m aa_h o_l
瞄	mi aa_l o_h
瞅	ch o_l u_l
瞌	k el_h el_h
瞍	s o_l u_l
瞎	xi a_h a_h
瞑	mi el_l ng_h
瞒	m a_l nn_h
瞧	qi aa_l o_h
瞩	zhu u_l u_l
瞪	d el_h ng_h
瞪	d el_h ng_l
瞬	shu el_h nn_l
瞰	k a_h nn_l
瞳	tu u_l ng_h
瞻	zh a_h nn_h
瞿	jv v_h v_l
瞿	qv v_l v_h
矗	chu u_h u_l
矛	m aa_l o_h
矜	gu a_h nn_h
矜	ji i_h nn_h
矜	qi i_l nn_h
矢	sh ib_l ib_l
矣	yi i_l i_l
知	zh ib_h ib_h
知	zh ib_h ib_l
矧	sh el_l nn_l
矩	jv v_l v_l
矩	jv v_m v_m
矫	ji aa_l o_h
矫	ji aa_l o_l
矬	cu o_l o_h
短	du a_l nn_l
矮	a_l eh_l
石	d a_h nn_l
石	sh ib_l ib_h
矶	ji i_h i_h
矸	g a_h nn_h
矽	xi i_h i_h
矾	f a_l nn_h
矿	ku aa_h ng_l
砀	d aa_h ng_l
码	m a_l a_l
砂	sh a_h a_h
砌	qi eh_h eh_l
砌	qi i_h i_l
砍	k a_l nn_l
研	yi a_h nn_l
研	yi a_l nn_h
砖	zhu a_h nn_h
砗	ch el_h el_h
砚	yi a_h nn_l
砜	f el_h ng_h
砝	f a_l a_l
砟	zh a_l a_l
砣	tu o_l o_h
砥	di i_l i_l
砦	zh a_h eh_l
砧	zh el_h nn_h
砩	f eh_h i_l
砩	fu u_l u_h
砬	l a_l a_h
砭	bi a_h nn_h
砰	p el_h ng_h
破	pu o_h o_l
砷	sh el_h nn_h
砸	z a_l a_h
砹	a_h eh_l
砺	li i_h i_l
砻	lu u_l ng_h
砼	tu u_l ng_h
砾	li i_h i_l
础	chu u_l u_l
硅	gu eh_h i_h
硇	n aa_l o_h
硌	g el_h el_l
硌	lu o_h o_l
硎	xi el_l ng_h
硐	du u_h ng_l
硒	xi i_h i_h
硕	shu o_h o_l
硖	xi a_l a_h
硗	qi aa_h o_h
硝	xi aa_h o_h
硪	wu o_h o_l
硫	li o_l u_h
硬	yi el_h ng_l
确	qv eh_h eh_l
硷	ji a_l nn_l
硼	p el_l ng_h
碇	di el_h ng_l
碉	di aa_h o_h
碌	li o_h u_l
碌	lu u_h u_h
碌	lu u_h u_l
碌	lu u_m u_m
碍	a_h eh_l
碎	su eh_h i_l
碑	b eh_h i_h
碓	du eh_h i_l
碗	wu a_l nn_l
碘	di a_l nn_l
碚	b eh_h i_l
碛	qi i_h i_l
碜	ch el_l nn_l
碜	ch el_m nn_m
碟	di eh_l eh_h
碡	zh o_l u_h
碣	ji eh_l eh_h
碥	bi a_l nn_l
碧	bi i_h i_l
碰	p el_h ng_l
碰	p el_m ng_m
碱	ji a_l nn_l
碲	di i_h i_l
碳	t a_h nn_l
碴	ch a_h a_h
碴	ch a_l a_h
碹	xv a_h nn_l
碾	ni a_l nn_l
磁	c if_l if_h
磅	b aa_h ng_l
磅	p aa_l ng_h
磉	s aa_l ng_l
磊	l eh_l i_l
磋	cu o_h o_h
磐	p a_l nn_h
磔	zh el_l el_h
磕	k el_h el_h
磕	k el_m el_m
磙	gu el_l nn_l
磨	mu o_h o_l
磨	mu o_l o_h
磨	mu o_m o_m
磬	qi el_h ng_l
磲	qv v_l v_h
磴	d el_h ng_l
磷	li i_l nn_h
磺	hu aa_l ng_h
礁	ji aa_h o_h
礅	du el_h nn_h
礓	ji aa_h ng_h
礤	c a_l a_l
礴	bu o_l o_h
示	sh ib_h ib_l
礼	li i_l i_l
社	sh el_h el_l
祀	s if_h if_l
祁	qi i_l i_h
祈	qi i_l i_h
祉	zh ib_l ib_l
祎	yi i_h i_h
祖	zu u_l u_l
祗	zh ib_h ib_h
祚	zu o_h o_l
祛	qv v_h v_h
祜	hu u_h u_l
祝	zhu u_h u_l
神	sh el_l nn_h
神	sh el_m nn_m
祟	su eh_h i_l
祠	c if_l if_h
祢	mi i_l i_h
祥	xi aa_l ng_h
票	pi aa_h o_l
祭	ji i_h i_l
祭	zh a_h eh_l
祯	zh el_h nn_h
祷	d aa_l o_l
祸	hu o_h o_l
祺	qi i_l i_h
禀	bi el_l ng_l
禁	ji i_h nn_h
禁	ji i_h nn_l
禄	lu u_h u_l
禅	ch a_l nn_h
禅	sh a_h nn_l
福	fu u_l u_h
禚	zhu o_l o_h
禧	xi i_l i_l
禹	yv v_l v_l
禺	yv v_l v_h
离	li i_l i_h
禽	qi i_l nn_h
禾	h el_l el_h
秀	xi o_h u_l
私	s if_h if_h
秃	tu u_h u_h
秆	g a_l nn_l
秉	bi el_l ng_l
秋	qi o_h u_h
种	chu u_l ng_h
种	zhu u_h ng_l
种	zhu u_l ng_l
科	k el_h el_h
秒	mi aa_l o_l
秕	bi i_l i_l
秘	bi i_h i_l
秘	mi i_h i_l
租	zu u_h u_h
秣	mu o_h o_l
秤	ch el_h ng_h
秤	ch el_h ng_l
秤	ch el_h nn_l
秦	qi i_l nn_h
秧	yi aa_h ng_h
秩	zh ib_h ib_l
秫	shu u_l u_h
秭	z if_l if_l
积	ji i_h i_h
称	ch el_h ng_h
称	ch el_h ng_l
称	ch el_h nn_l
秸	ji eh_h eh_h
秸	ji eh_m eh_m
移	yi i_l i_h
稀	xi i_h i_h
稀	xi i_m i_m
稂	l aa_l ng_h
稆	lv v_l v_l
程	ch el_l ng_h
稍	sh aa_h o_h
稍	sh aa_h o_l
税	shu eh_h i_l
稔	r el_l nn_l
稗	b a_h eh_l
稚	zh ib_h ib_l
稞	k el_h el_h
稠	ch o_l u_h
稣	su u_h u_h
稳	wu el_l nn_l
稷	ji i_h i_l
稹	zh el_l nn_l
稻	d aa_h o_l
稼	ji a_h a_l
稼	ji a_m a_m
稽	ji i_h i_h
稽	qi i_l i_l
稿	g aa_l o_l
穆	mu u_h u_l
穑	s el_h el_l
穗	su eh_h i_l
穰	r aa_l ng_h
穴	xv eh_h eh_l
穴	xv eh_l eh_h
究	ji o_h u_h
究	ji o_m u_m
穷	qv u_l ng_h
穹	qv u_l ng_h
空	ku u_h ng_h
空	ku u_h ng_l
空	ku u_m ng_m
穿	chu a_h nn_h
窀	zhu el_h nn_h
突	tu u_h u_h
窃	qi eh_h eh_l
窄	zh a_l eh_l
窈	yi aa_l o_l
窍	qi aa_h o_l
窑	yi aa_l o_h
窒	zh ib_h ib_l
窕	ti aa_l o_l
窖	ji aa_h o_l
窗	chu aa_h ng_h
窘	jv u_l ng_l
窜	cu a_h nn_l
窝	wu o_h o_h
窝	wu o_m o_m
窟	ku u_h u_h
窠	k el_h el_h
窥	ku eh_h i_h
窦	d o_h u_l
窨	xv el_h nn_h
窨	yi i_h nn_l
窬	yv v_l v_h
窭	jv v_h v_l
窭	l o_l u_h
窳	yv v_l v_l
窿	lu u_l ng_h
立	li i_h i_l
竖	shu u_h u_l
站	zh a_h nn_l
竞	ji el_h ng_l
竟	ji el_h ng_l
章	zh aa_h ng_h
竣	jv el_h nn_l
童	tu u_l ng_h
竦	su u_l ng_l
竭	ji eh_l eh_h
端	du a_h nn_h
竹	zhu u_l u_h
竺	zhu u_l u_h
竽	yv v_l v_h
竿	g a_h nn_h
笃	du u_l u_l
笄	ji i_h i_h
笆	b a_h a_h
笆	b a_m a_m
笈	ji i_l i_h
笊	zh aa_h o_l
笋	su el_l nn_l
笏	hu u_h u_l
笑	xi aa_h o_l
笔	bi i_l i_l
笕	ji a_l nn_l
笙	sh el_h ng_h
笛	di i_l i_h
笠	li i_h i_l
笤	ti aa_l o_h
笥	s if_h if_l
符	fu u_l u_h
笨	b el_h nn_l
笪	d a_l a_h
笫	z if_l if_l
第	di i_h i_l
笮	z el_l el_h
笮	zu o_l o_h
笳	ji a_h a_h
笸	pu o_l o_l
笺	ji a_h nn_h
笼	lu u_l ng_h
笼	lu u_l ng_l
笼	lu u_m ng_m
筇	qv u_l ng_h
等	d el_l ng_l
筋	ji i_h nn_h
筌	qv a_l nn_h
筏	f a_l a_h
筐	ku aa_h ng_h
筑	zhu u_h u_l
筑	zhu u_l u_h
筒	tu u_l ng_l
答	d a_h a_h
答	d a_l a_h
策	c el_h el_l
筘	k o_h u_l
筚	bi i_h i_l
筛	sh a_h eh_h
筝	zh el_h ng_h
筠	jv el_h nn_h
筠	yv el_l nn_h
筢	p a_l a_h
筱	xi aa_l o_l
筲	sh aa_h o_h
筵	yi a_l nn_h
筷	ku a_h eh_l
筹	ch o_l u_h
筻	g aa_h ng_l
签	qi a_h nn_h
简	ji a_l nn_l
箅	bi i_h i_l
箍	gu u_h u_h
箐	ji el_h ng_h
箐	qi el_h ng_l
箔	bu o_l o_h
箕	ji i_h i_h
箕	ji i_m i_m
算	su a_h nn_l
算	su a_m nn_m
箜	ku u_h ng_h
管	gu a_l nn_l
箢	wu a_h nn_h
箢	yv a_h nn_h
箦	z el_l el_h
箩	lu o_l o_h
箩	lu o_m o_m
箪	d a_h nn_h
箫	xi aa_h o_h
箬	ru o_h o_l
箭	ji a_h nn_l
箱	xi aa_h ng_h
箴	zh el_h nn_h
箸	zhu u_h u_l
篁	hu aa_l ng_h
篆	zhu a_h nn_l
篇	pi a_h nn_h
篑	ku eh_h i_l
篓	l o_l u_l
篙	g aa_h o_h
篚	f eh_l i_l
篝	g o_h u_h
篡	cu a_h nn_l
篦	bi i_h i_l
篪	ch ib_l ib_h
篮	l a_l nn_h
篱	li i_l i_h
篷	p el_l ng_h
篷	p el_m ng_m
篼	d o_h u_h
篾	mi eh_h eh_l
簇	cu u_h u_l
簋	gu eh_l i_l
簌	su u_h u_l
簏	lu u_h u_l
簖	du a_h nn_l
簟	di a_h nn_l
簧	hu aa_l ng_h
簪	z a_h nn_h
簸	bu o_h o_l
簸	bu o_l o_l
簿	bu u_h u_l
籁	l a_h eh_l
籍	ji i_l i_h
米	mi i_l i_l
籴	di i_l i_h
类	l eh_h i_l
籼	xi a_h nn_h
籽	z if_l if_l
籽	z if_m if_m
粉	f el_l nn_l
粑	b a_h a_h
粒	li i_h i_l
粕	pu o_h o_l
粗	cu u_h u_h
粘	ni a_l nn_h
粘	zh a_h nn_h
粜	ti aa_h o_l
粞	xi i_h i_h
粟	su u_h u_l
粢	c if_h if_h
粢	z if_h if_h
粤	yv eh_h eh_l
粥	yv v_h v_l
粥	zh o_h u_h
粪	f el_h nn_l
粮	li aa_l ng_h
粱	li aa_l ng_h
粱	li aa_m ng_m
粲	c a_h nn_l
粳	ji el_h ng_h
粹	cu eh_h i_l
粼	li i_l nn_h
粽	zu u_h ng_l
精	ji el_h ng_h
糁	s a_l nn_l
糁	sh el_h nn_h
糅	r o_l u_h
糊	hu u_h u_h
糊	hu u_h u_l
糊	hu u_l u_h
糊	hu u_m u_m
糌	z a_h nn_h
糍	c if_l if_h
糕	g aa_h o_h
糖	t aa_l ng_h
糗	qi o_l u_l
糙	c aa_h o_h
糙	c aa_m o_m
糜	m eh_l i_h
糜	mi i_l i_h
糟	z aa_h o_h
糠	k aa_h ng_h
糯	nu o_h o_l
糸	ji aa_l o_l
糸	mi i_h i_l
系	ji i_h i_l
系	xi i_h i_l
系	xi i_m i_m
素	su u_h u_l
索	su o_l o_l
紧	ji i_l nn_l
紫	z if_l if_l
累	l eh_h i_l
累	l eh_l i_h
累	l eh_l i_l
絮	xv v_h v_l
綦	qi i_l i_h
繁	f a_l nn_h
繁	pu o_l o_h
繇	yi aa_l o_h
繇	yi o_l u_h
繇	zh o_h u_l
纂	zu a_l nn_l
纛	d aa_h o_l
纠	ji o_h u_h
纡	yv v_h v_h
红	gu u_h ng_h
红	hu u_h ng_h
红	hu u_l ng_h
纣	zh o_h u_l
纤	qi a_h nn_l
纤	xi a_h nn_h
约	yi aa_h o_h
约	yv eh_h eh_h
级	ji i_l i_h
纨	wu a_l nn_h
纪	ji i_h i_l
纪	ji i_l i_l
纪	ji i_m i_m
纫	r el_h nn_l
纬	wu eh_l i_l
纭	yv el_l nn_h
纯	chu el_l nn_h
纱	sh a_h a_h
纲	g aa_h ng_h
纳	n a_h a_l
纵	zu u_h ng_l
纶	gu a_h nn_h
纶	lu el_l nn_h
纷	f el_h nn_h
纸	zh ib_l ib_l
纹	wu el_h nn_l
纹	wu el_l nn_h
纺	f aa_l ng_l
纽	ni o_l u_l
纾	shu u_h u_h
线	xi a_h nn_l
线	xi a_m nn_m
绀	g a_h nn_l
练	li a_h nn_l
组	zu u_l u_l
绅	sh el_h nn_h
细	xi i_h i_l
细	xi i_m i_m
织	zh ib_h ib_h
织	zh ib_h ib_l
终	zhu u_h ng_h
绉	zh o_h u_l
绊	b a_h nn_l
绌	chu u_h u_l
绍	sh aa_h o_l
绎	yi i_h i_l
经	ji el_h ng_h
经	ji el_h ng_l
经	ji el_m ng_m
绐	d a_h eh_l
绑	b aa_l ng_l
绒	ru u_l ng_h
结	ji eh_h eh_h
结	ji eh_l eh_h
结	ji eh_m eh_m
绕	r aa_h o_l
绗	h aa_l ng_h
绘	hu eh_h i_l
给	g eh_l i_l
给	ji i_l i_l
绚	xv a_h nn_l
绚	xv el_l nn_h
绛	ji aa_h ng_l
络	l aa_h o_l
络	lu o_h o_l
绝	jv eh_l eh_h
绞	ji aa_l o_l
统	tu u_l ng_l
绡	xi aa_h o_h
绢	jv a_h nn_l
绣	xi o_h u_l
绥	su eh_l i_h
绦	t aa_h o_h
继	ji i_h i_l
绨	ti i_h i_l
绨	ti i_l i_h
绩	ji i_h i_l
绪	xv v_h v_l
绫	li el_l ng_h
续	xv v_h v_l
绮	qi i_l i_l
绯	f eh_h i_h
绰	ch aa_h o_h
绰	chu o_h o_l
绰	chu o_m o_m
绱	sh aa_h ng_l
绳	sh el_l ng_h
维	wu eh_l i_h
绵	mi a_l nn_h
绶	sh o_h u_l
绷	b el_h ng_h
绷	b el_h ng_l
绷	b el_l ng_l
绸	ch o_l u_h
绻	qv a_l nn_l
综	z el_h ng_l
综	zu u_h ng_h
绽	zh a_h nn_l
绾	wu a_l nn_l
绿	lu u_h u_l
绿	lv v_h v_l
缀	chu o_h o_l
缀	zhu eh_h i_l
缁	z if_h if_h
缂	k el_h el_l
缃	xi aa_h ng_h
缄	ji a_h nn_h
缅	mi a_l nn_l
缆	l a_l nn_l
缇	ti i_l i_h
缈	mi aa_l o_l
缉	ji i_h i_h
缉	qi i_h i_h
缌	s if_h if_h
缍	du o_l o_l
缎	du a_h nn_l
缑	g o_h u_h
缓	hu a_l nn_l
缔	di i_h i_l
缕	lv v_l v_l
缕	lv v_m v_m
编	bi a_h nn_h
缗	mi a_l nn_h
缗	mi i_l nn_h
缘	yv a_h nn_l
缘	yv a_l nn_h
缙	ji i_h nn_l
缚	fu u_h u_l
缜	zh el_l nn_l
缝	f el_h ng_l
缝	f el_l ng_h
缝	f el_m ng_m
缠	ch a_l nn_h
缠	ch a_m nn_m
缡	li i_l i_h
缢	yi i_h i_l
缤	bi i_h nn_h
缥	pi aa_h o_h
缥	pi aa_l o_l
缦	m a_h nn_l
缧	l eh_l i_h
缨	yi el_h ng_h
缩	su o_h o_h
缩	su u_h u_l
缪	mi aa_h o_l
缪	mi o_h u_l
缪	m o_l u_h
缫	s aa_h o_h
缭	li aa_l o_h
缮	sh a_h nn_l
缯	z el_h ng_h
缯	z el_h ng_l
缰	ji aa_h ng_h
缴	ji aa_l o_l
缴	zhu o_l o_h
缵	zu a_l nn_l
缶	f o_l u_l
缸	g aa_h ng_h
缺	qv eh_h eh_h
罂	yi el_h ng_h
罄	qi el_h ng_l
罅	xi a_h a_l
罐	gu a_h nn_l
网	wu aa_l ng_l
罔	wu aa_l ng_l
罕	h a_l nn_l
罕	h a_m nn_m
罗	lu o_l o_h
罗	lu o_m o_m
罘	fu u_l u_h
罚	f a_l a_h
罟	gu u_l u_l
罡	g aa_h ng_h
罢	b a_h a_h
罢	b a_h a_l
罢	pi i_l i_h
罨	yi a_l nn_l
罩	zh aa_h o_l
罪	zu eh_h i_l
置	zh ib_h ib_l
署	shu u_l u_l
罹	li i_l i_h
罾	z el_h ng_h
羁	ji i_h i_h
羊	yi aa_l ng_h
羌	qi aa_h ng_h
美	m eh_l i_l
羔	g aa_h o_h
羚	li el_l ng_h
羞	xi o_h u_h
羡	xi a_h nn_l
群	qv el_l nn_h
羯	ji eh_l eh_h
羲	xi i_h i_h
羸	l eh_l i_h
羹	g el_h ng_h
羽	yv v_l v_l
羿	yi i_h i_l
翁	wu el_h ng_h
翅	ch ib_h ib_l
翊	yi i_h i_l
翌	yi i_h i_l
翎	li el_l ng_h
翔	xi aa_l ng_h
翕	xi i_h i_h
翘	qi aa_h o_l
翘	qi aa_l o_h
翟	di i_l i_h
翟	zh a_l eh_h
翠	cu eh_h i_l
翡	f eh_l i_l
翥	zhu u_h u_l
翦	ji a_l nn_l
翩	pi a_h nn_h
翮	h el_l el_h
翰	h a_h nn_l
翱	aa_l o_h
翳	yi i_h i_l
翻	f a_h nn_h
翼	yi i_h i_l
耀	yi aa_h o_l
老	l aa_l o_l
考	k aa_l o_l
耄	m aa_h o_l
者	zh el_l el_l
耆	qi i_l i_h
耋	di eh_l eh_h
而	er_l er_h
而	er_l er_l
耍	shu a_l a_l
耐	n a_h eh_l
耒	l eh_l i_l
耕	g el_h ng_h
耗	h aa_h o_l
耘	yv el_l nn_h
耙	b a_h a_l
耙	p a_l a_h
耥	t aa_h ng_h
耥	t aa_l ng_l
耦	o_l u_l
耧	l o_l u_h
耨	n o_h u_l
耩	ji aa_l ng_l
耳	er_l er_l
耵	di el_h ng_h
耶	yi eh_h eh_h
耶	yi eh_l eh_h
耷	d a_h a_h
耸	su u_l ng_l
耻	ch ib_l ib_l
耽	d a_h nn_h
耿	g el_l ng_l
聂	ni eh_h eh_l
聃	d a_h nn_h
聆	li el_l ng_h
聊	li aa_l o_h
聋	lu u_l ng_h
职	zh ib_l ib_h
联	li a_l nn_h
聘	pi i_h nn_l
聚	jv v_h v_l
聪	cu u_h ng_h
聿	yv v_h v_l
肃	su u_h u_l
肆	s if_h if_l
肇	zh aa_h o_l
肉	r o_h u_l
肋	l eh_h i_l
肋	l el_h el_h
肌	ji i_h i_h
肓	hu aa_h ng_h
肖	xi aa_h o_h
肖	xi aa_h o_l
肘	zh o_l u_l
肚	du u_h u_l
肚	du u_l u_l
肚	du u_m u_m
肛	g aa_h ng_h
肜	ru u_l ng_h
肝	g a_h nn_h
肠	ch aa_l ng_h
股	gu u_l u_l
股	gu u_m u_m
肢	zh ib_h ib_h
肢	zh ib_m ib_m
肤	fu u_h u_h
肥	f eh_l i_h
肩	ji a_h nn_h
肪	f aa_l ng_h
肫	zhu el_h nn_h
肮	aa_h ng_h
肯	k el_l nn_l
育	yi o_h o_h
育	yv v_h v_l
肴	yi aa_l o_h
肷	qi a_l nn_l
肺	f eh_h i_l
肽	t a_h eh_l
肾	sh el_h nn_l
肿	zhu u_l ng_l
胀	zh aa_h ng_l
胁	xi eh_l eh_h
胃	wu eh_h i_l
胄	zh o_h u_l
胆	d a_l nn_l
背	b eh_h i_h
背	b eh_h i_l
胎	t a_h eh_h
胖	p aa_h ng_l
胖	p a_l nn_h
胗	zh el_h nn_h
胙	zu o_h o_l
胚	p eh_h i_h
胜	sh el_h ng_h
胜	sh el_h ng_l
胝	zh ib_h ib_h
胞	b aa_h o_h
胡	hu u_l u_h
胡	hu u_m u_m
胤	yi i_h nn_l
胥	xv v_h v_h
胧	lu u_l ng_h
胩	k a_l a_l
胪	lu u_l u_h
胫	ji el_h ng_l
胭	yi a_h nn_h
胯	ku a_h a_l
胰	yi i_l i_h
胱	gu aa_h ng_h
胳	g a_h a_h
胳	g el_h el_h
胳	g el_h el_h g el_l el_h
胳	g el_l el_h
胴	du u_h ng_l
胶	ji aa_h o_h
胸	xv u_h ng_h
胺	a_h nn_l
能	n el_l ng_h
脂	zh ib_h ib_h
脂	zh ib_l ib_l
脆	cu eh_h i_l
脉	m a_h eh_l
脉	mu o_h o_l
脊	ji i_l i_l
脊	ji i_m i_m
脍	ku a_h eh_l
脏	z aa_h ng_h
脏	z aa_h ng_l
脐	qi i_l i_h
脑	n aa_l o_l
脖	bu o_l o_h
脘	wu a_l nn_l
脚	ji aa_l o_l
脚	jv eh_l eh_h
脯	fu u_l u_l
脯	pu u_l u_h
脱	tu eh_h i_l
脱	tu o_h o_h
脲	ni aa_h o_l
脸	li a_l nn_l
脾	pi i_l i_h
腈	ji el_h ng_h
腊	l a_h a_l
腊	xi i_h i_h
腋	yi eh_h eh_l
腌	a_h a_h
腌	yi a_h nn_h
腐	fu u_l u_l
腐	fu u_m u_m
腑	fu u_l u_l
腓	f eh_l i_h
腔	qi aa_h ng_h
腕	wu a_h nn_l
腙	zu u_h ng_h
腚	di el_h ng_l
腠	c o_h u_l
腥	xi el_h ng_h
腧	shu u_h u_l
腩	n a_l nn_l
腮	s a_h eh_h
腰	yi aa_h o_h
腰	yi aa_m o_m
腱	ji a_h nn_l
腴	yv v_l v_h
腹	fu u_h u_l
腺	xi a_h nn_l
腻	ni i_h i_l
腽	wu a_h a_l
腾	t el_h ng_h
腾	t el_l ng_h
腾	t el_m ng_m
腿	tu eh_l i_l
膀	b aa_h ng_l
膀	b aa_l ng_l
膀	p aa_h ng_h
膀	p aa_l ng_h
膊	bu o_l o_h
膊	bu o_m o_m
膏	g aa_h o_h
膏	g aa_h o_l
膑	bi i_h nn_l
膘	bi aa_h o_h
膛	t aa_l ng_h
膜	mu o_l o_h
膝	xi i_h i_h
膣	zh ib_h ib_l
膦	li i_h nn_l
膨	p el_l ng_h
膪	chu a_h eh_l
膳	sh a_h nn_l
膺	yi el_h ng_h
膻	sh a_h nn_h
臀	tu el_l nn_h
臁	li a_l nn_h
臂	b eh_m i_m
臂	bi i_h i_l
臆	yi i_h i_l
臊	s aa_h o_h
臊	s aa_h o_l
臣	ch el_l nn_h
臧	z aa_h ng_h
自	z if_h if_l
臬	ni eh_h eh_l
臭	ch o_h u_l
臭	xi o_h u_l
至	zh ib_h ib_l
致	zh ib_h ib_l
臻	zh el_h nn_h
臼	ji o_h u_l
臾	yv v_l v_h
舀	yi aa_l o_l
舁	yv v_l v_h
舂	chu u_h ng_h
舅	ji o_h u_l
舆	yv v_l v_h
舌	sh el_l el_h
舍	sh el_h el_l
舍	sh el_l el_l
舒	shu u_h u_h
舔	ti a_l nn_l
舜	shu el_h nn_l
舞	wu u_l u_l
舟	zh o_h u_h
舢	sh a_h nn_h
舣	yi i_l i_l
舨	b a_l nn_l
航	h aa_l ng_h
舫	f aa_l ng_l
般	b a_h nn_h
般	bu o_h o_h
般	p a_l nn_h
舭	bi i_l i_l
舰	ji a_h nn_l
舱	c aa_h ng_h
舵	du o_h o_l
舵	tu o_l o_h
舶	bu o_l o_h
舷	xi a_l nn_h
舸	g el_l el_l
船	chu a_l nn_h
舾	xi i_h i_h
艄	sh aa_h o_h
艇	ti el_l ng_l
艋	m el_l ng_l
艏	sh o_l u_l
艘	s o_h u_h
艚	c aa_l o_h
艮	g el_h nn_l
艮	g el_l nn_l
良	li aa_l ng_h
艰	ji a_h nn_h
色	s el_h el_l
色	s el_m el_m
色	sh a_l eh_l
艳	yi a_h nn_l
艴	fu u_l u_h
艺	yi i_h i_l
艽	ji aa_h o_h
艾	a_h eh_l
艾	yi i_h i_l
艿	n a_l eh_l
节	ji eh_h eh_h
节	ji eh_l eh_h
节	ji eh_m eh_m
芄	wu a_l nn_h
芈	mi i_l i_l
芊	qi a_h nn_h
芋	yv v_h v_l
芍	sh aa_l o_h
芎	xv u_h ng_h
芏	du u_h u_l
芑	qi i_l i_l
芒	m aa_l ng_h
芗	xi aa_h ng_h
芘	pi i_l i_h
芙	fu u_l u_h
芜	wu u_l u_h
芝	zh ib_h ib_h
芡	qi a_h nn_l
芥	g a_h eh_l
芥	ji eh_h eh_l
芦	lu u_l u_h
芦	lu u_l u_l
芦	lu u_m u_m
芨	ji i_h i_h
芩	qi i_l nn_h
芪	qi i_l i_h
芫	yi a_l nn_h
芫	yv a_l nn_h
芬	f el_h nn_h
芭	b a_h a_h
芮	ru eh_h i_l
芯	xi i_h nn_h
芯	xi i_h nn_l
芰	ji i_h i_l
花	hu a_h a_h
花	hu a_m a_m
芳	f aa_h ng_h
芴	wu u_h u_l
芷	zh ib_l ib_l
芸	yv el_l nn_h
芹	qi i_l nn_h
芽	yi a_l a_h
芾	f eh_h i_l
芾	fu u_l u_h
苁	cu u_h ng_h
苇	wu eh_l i_l
苋	xi a_h nn_l
苌	ch aa_l ng_h
苍	c aa_h ng_h
苎	zhu u_h u_l
苏	su u_h u_h
苑	yv a_h nn_l
苒	r a_l nn_l
苓	li el_l ng_h
苔	t a_h eh_h
苔	t a_l eh_h
苕	sh aa_l o_h
苕	ti aa_l o_h
苗	mi aa_l o_h
苘	qi el_l ng_l
苛	k el_h el_h
苜	mu u_h u_l
苞	b aa_h o_h
苟	g o_l u_l
苠	mi i_l nn_h
苡	yi i_l i_l
苣	jv v_h v_l
苣	qv v_l v_l
苤	pi eh_l eh_l
若	r el_l el_l
若	ru o_h o_l
苦	ku u_l u_l
苫	sh a_h nn_h
苫	sh a_h nn_l
苯	b el_l nn_l
英	yi el_h ng_h
苴	jv v_h v_h
苷	g a_h nn_h
苹	pi el_l ng_h
茁	zhu o_l o_h
茂	m aa_h o_l
范	f a_h nn_l
茄	ji a_h a_h
茄	qi eh_l eh_h
茅	m aa_l o_h
茆	m aa_l o_h
茈	c if_l if_h
茈	z if_l if_l
茉	mu o_h o_l
茌	ch ib_l ib_h
茎	ji el_h ng_h
茏	lu u_l ng_h
茏	lu u_l ng_l
茑	ni aa_l o_l
茔	yi el_l ng_h
茗	mi el_l ng_h
茚	yi i_h nn_l
茛	g el_h nn_l
茜	qi a_h nn_l
茜	xi i_h i_h
茧	ji a_l nn_l
茨	c if_l if_h
茫	m aa_h ng_h
茫	m aa_l ng_h
茬	ch a_l a_h
茭	ji aa_h o_h
茯	fu u_l u_h
茱	zhu u_h u_h
茳	ji aa_h ng_h
茴	hu eh_l i_h
茵	yi i_h nn_h
茶	ch a_l a_h
茸	ru u_h ng_h
茸	ru u_l ng_h
茹	ru u_l u_h
茼	tu u_l ng_h
荀	xv el_l nn_h
荃	qv a_l nn_h
荆	ji el_h ng_h
荇	xi el_h ng_l
草	c aa_l o_l
荏	r el_l nn_l
荐	ji a_h nn_l
荑	ti i_l i_h
荑	yi i_l i_h
荒	hu aa_h ng_h
荒	hu aa_m ng_m
荔	li i_h i_l
荚	ji a_l a_h
荛	r aa_l o_h
荛	yi aa_l o_h
荜	bi i_h i_l
荞	qi aa_l o_h
荟	hu eh_h i_l
荠	c if_l if_h
荠	ji i_h i_l
荠	qi i_l i_h
荡	d aa_h ng_l
荡	d aa_m ng_m
荣	ru u_l ng_h
荤	hu el_h nn_h
荤	xv el_h nn_h
荥	xi el_l ng_h
荥	yi el_l ng_h
荦	lu o_h o_l
荧	yi el_l ng_h
荨	qi a_l nn_h
荨	xv el_l nn_h
荩	ji i_h nn_l
荪	su el_h nn_h
荫	yi i_h nn_h
荫	yi i_h nn_l
荬	m a_l eh_l
荭	hu u_l ng_h
荮	zh o_h u_l
药	yi aa_h o_l
药	yi aa_m o_m
荷	h el_h el_l
荷	h el_l el_h
荷	h el_m el_m
荸	bi i_l i_h
荻	di i_l i_h
荼	tu u_l u_h
莅	li i_h i_l
莆	pu u_l u_h
莉	li i_h i_l
莎	sh a_h a_h
莎	su o_h o_h
莒	jv v_l v_l
莓	m eh_l i_h
莘	sh el_h nn_h
莘	xi i_h nn_h
莛	ti el_l ng_h
莜	yi o_l u_h
莞	gu a_h nn_h
莞	gu a_l nn_l
莞	wu a_l nn_l
莠	yi o_l u_l
莨	l aa_h ng_l
莨	li aa_l ng_h
莪	el_l el_h
莫	mu o_h o_l
莫	mu o_m o_m
莱	l a_l eh_h
莲	li a_l nn_h
莳	sh ib_h ib_l
莳	sh ib_l ib_h
莴	wu o_h o_h
获	hu o_h o_l
莹	yi el_h ng_h
莹	yi el_l ng_h
莹	yi el_l ng_l
莺	yi el_h ng_h
莼	chu el_l nn_h
莽	m aa_l ng_l
菀	wu a_l nn_l
菀	yv v_h v_l
菁	ji el_h ng_h
菅	ji a_h nn_h
菇	gu u_h u_h
菇	gu u_m u_m
菊	jv v_l v_h
菌	jv el_h nn_h
菌	jv el_h nn_l
菏	h el_l el_h
菖	ch aa_h ng_h
菘	su u_h ng_h
菜	c a_h eh_l
菟	tu u_h u_l
菟	tu u_l u_h
菠	bu o_h o_h
菡	h a_h nn_l
菥	xi i_h i_h
菩	pu u_l u_h
菰	gu u_h u_h
菱	li el_l ng_h
菲	f eh_h i_h
菲	f eh_l i_l
菸	yi a_h nn_h
菹	jv v_h v_l
菹	zu u_h u_h
菽	shu u_h u_h
萁	qi i_l i_h
萃	cu eh_h i_l
萄	t aa_l o_h
萌	m el_l ng_h
萍	pi el_l ng_h
萎	wu eh_h i_h
萎	wu eh_h i_l
萎	wu eh_l i_l
萘	n a_h eh_l
萝	lu o_l o_h
萤	yi el_l ng_h
营	yi el_l ng_h
萦	yi el_l ng_h
萧	xi aa_h o_h
萨	s a_h a_l
萱	xv a_h nn_h
萸	yv v_l v_h
萼	el_h el_l
落	l aa_h o_l
落	l a_h a_l
落	lu o_h o_h
落	lu o_h o_l
落	lu o_m o_m
葆	b aa_l o_l
葑	f el_h ng_h
葑	f el_h ng_l
著	zh el_m el_m
著	zhu o_l o_h
著	zhu u_h u_l
葚	r el_h nn_l
葚	sh el_h nn_l
葛	g el_l el_h
葛	g el_l el_l
葜	qi a_h a_h
葡	pu u_l u_h
董	du u_l ng_l
葩	p a_h a_h
葫	hu u_l u_h
葫	hu u_m u_m
葬	z aa_h ng_l
葭	ji a_h a_h
葱	cu u_h ng_h
葳	wu eh_h i_h
葵	ku eh_l i_h
葶	ti el_l ng_h
葸	xi i_l i_l
葺	qi i_h i_l
蒂	di i_h i_l
蒋	ji aa_l ng_l
蒌	l o_l u_h
蒎	p a_h eh_l
蒗	l aa_h ng_l
蒙	m el_h ng_h
蒙	m el_l ng_h
蒙	m el_l ng_l
蒜	su a_h nn_l
蒡	b aa_h ng_l
蒡	p aa_l ng_h
蒯	ku a_l eh_l
蒲	pu u_l u_h
蒴	shu o_h o_l
蒸	zh el_h ng_h
蒹	ji a_h nn_h
蒽	el_h nn_h
蒿	h aa_h o_h
蓁	zh el_h nn_h
蓄	xv v_h v_l
蓉	ru u_l ng_h
蓊	wu el_l ng_l
蓍	sh ib_h ib_h
蓑	su o_h o_h
蓓	b eh_h i_l
蓖	bi i_h i_l
蓝	l a_l nn_h
蓝	l a_m nn_m
蓟	ji i_h i_l
蓠	li i_l i_h
蓥	yi el_l ng_h
蓦	mu o_h o_l
蓬	p el_l ng_h
蓼	li aa_l o_l
蓼	lu u_h u_l
蓿	xv v_m v_m
蔌	su u_h u_l
蔑	mi eh_h eh_l
蔓	m a_h nn_l
蔓	m a_l nn_h
蔓	wu a_h nn_l
蔗	zh el_h el_l
蔚	wu eh_h i_l
蔚	yv v_h v_l
蔡	c a_h eh_l
蔫	ni a_h nn_h
蔬	shu u_h u_h
蔷	qi aa_l ng_h
蔸	d o_h u_h
蔺	li i_h nn_l
蔻	k o_h u_l
蔼	a_l eh_l
蔽	bi i_h i_l
蕃	f a_h nn_h
蕃	f a_l nn_h
蕈	xv el_h nn_l
蕉	ji aa_h o_h
蕉	qi aa_l o_h
蕊	ru eh_l i_l
蕖	qv v_l v_h
蕙	hu eh_h i_l
蕞	zu eh_h i_l
蕤	ru eh_l i_h
蕨	jv eh_l eh_h
蕲	qi i_l i_h
蕴	wu el_h nn_h
蕴	yv el_h nn_l
蕺	ji i_l i_h
蕻	hu u_h ng_l
蕻	hu u_l ng_h
蕾	l eh_l i_l
薄	b aa_l o_h
薄	bu o_h o_l
薄	bu o_l o_h
薅	h aa_h o_h
薇	wu eh_h i_h
薏	yi i_h i_l
薛	xv eh_h eh_h
薜	bi i_h i_l
薤	xi eh_h eh_l
薨	hu u_h ng_h
薪	xi i_h nn_h
薮	s o_l u_l
薯	shu u_l u_l
薰	xv el_h nn_h
薷	ru u_l u_h
薹	t a_l eh_h
藁	g aa_l o_l
藉	ji eh_h eh_l
藉	ji i_l i_h
藏	c aa_l ng_h
藏	z aa_h ng_l
藐	mi aa_l o_l
藓	xi a_l nn_l
藕	o_l u_l
藜	li i_l i_h
藜	li i_m i_m
藤	t el_l ng_h
藩	f a_h nn_h
藻	z aa_l o_l
藿	hu o_h o_l
蘅	h el_l ng_h
蘑	mu o_l o_h
蘩	f a_l nn_h
蘸	zh a_h nn_l
蘼	mi i_l i_h
虎	hu u_h u_h
虎	hu u_h u_l
虎	hu u_l u_l
虎	hu u_m u_m
虏	lu u_l u_l
虐	nv eh_h eh_l
虑	lv v_h v_l
虔	qi a_l nn_h
虚	xv v_h v_h
虞	yv v_l v_h
虢	gu o_l o_h
虫	chu u_l ng_h
虫	chu u_m ng_m
虬	qi o_l u_h
虱	sh ib_h ib_h
虹	hu u_l ng_h
虹	ji aa_h ng_l
虻	m el_l ng_h
虼	g el_h el_l
虽	su eh_h i_h
虾	h a_l a_h
虾	xi a_h a_h
蚀	sh ib_l ib_h
蚁	yi i_l i_l
蚂	m a_h a_h
蚂	m a_h a_l
蚂	m a_l a_l
蚊	wu el_l nn_h
蚌	b aa_h ng_l
蚌	b el_h ng_l
蚓	yi i_l nn_l
蚕	c a_l nn_h
蚝	h aa_l o_h
蚣	gu u_h ng_h
蚤	z aa_l o_l
蚤	z aa_m o_m
蚧	ji eh_h eh_l
蚨	fu u_l u_h
蚩	ch ib_h ib_h
蚪	d o_l u_l
蚬	xi a_h nn_l
蚬	xi a_l nn_l
蚯	qi o_h u_h
蚰	yi o_l u_h
蚱	zh a_h a_l
蚱	zh a_m a_m
蚵	k el_h el_h
蚶	h a_h nn_h
蚺	r a_l nn_h
蛀	zhu u_h u_l
蛄	gu u_h u_h
蛄	gu u_l u_l
蛇	sh el_l el_h
蛇	yi i_l i_h
蛉	li el_l ng_h
蛊	gu u_l u_l
蛋	d a_h nn_l
蛎	li i_h i_l
蛏	ch el_h ng_h
蛐	qv v_h v_h
蛐	qv v_m v_m
蛘	yi aa_l ng_h
蛙	wu a_h a_h
蛛	zhu u_h u_h
蛛	zhu u_m u_m
蛞	ku o_h o_l
蛟	ji aa_h o_h
蛤	g el_l el_h
蛤	h a_l a_h
蛭	zh ib_h ib_l
蛮	m a_l nn_h
蛰	zh el_l el_h
蛳	s if_h if_h
蛸	sh aa_h o_h
蛸	xi aa_h o_h
蛹	yi u_l ng_l
蛾	el_l el_h
蛾	yi i_l i_l
蜀	shu u_l u_l
蜂	f el_h ng_h
蜃	sh el_h nn_l
蜇	zh el_h el_h
蜇	zh el_l el_h
蜈	wu u_l u_h
蜉	fu u_l u_h
蜊	li i_l i_h
蜍	chu u_l u_h
蜒	yi a_l nn_h
蜓	ti el_l ng_h
蜕	tu eh_h i_l
蜗	lu o_l o_h
蜗	wu o_h o_h
蜘	zh ib_h ib_h
蜚	f eh_h i_h
蜚	f eh_l i_l
蜜	mi i_h i_l
蜞	qi i_l i_h
蜡	l a_h a_l
蜡	xi i_h i_h
蜡	zh a_h a_l
蜢	m el_l ng_l
蜥	xi i_h i_h
蜮	yv v_h v_l
蜴	yi i_h i_l
蜻	qi el_h ng_h
蝇	yi el_l ng_h
蝇	yi el_m ng_m
蝈	gu o_h o_h
蝉	ch a_l nn_h
蝌	k el_h el_h
蝎	xi eh_h eh_h
蝓	yv v_l v_h
蝗	hu aa_l ng_h
蝙	bi a_h nn_h
蝠	fu u_l u_h
蝤	qi o_l u_h
蝤	yi o_l u_h
蝴	hu u_l u_h
蝶	di eh_l eh_h
蝼	l o_l u_h
螂	l aa_l ng_h
螂	l aa_m ng_m
螃	p aa_l ng_h
螅	xi i_h i_h
螋	s o_h u_h
融	ru u_l ng_h
螨	m a_l nn_l
螭	ch ib_h ib_h
螯	aa_l o_h
螳	t aa_l ng_h
螺	lu o_l o_h
螽	zhu u_h ng_h
蟀	shu a_h eh_l
蟆	m a_l a_h
蟆	m a_m a_m
蟋	xi i_h i_h
蟑	zh aa_h ng_h
蟒	m aa_l ng_l
蟛	p el_l ng_h
蟠	p a_l nn_h
蟥	hu aa_l ng_h
蟪	hu eh_h i_l
蟮	sh a_h nn_l
蟹	xi eh_h eh_l
蟾	ch a_l nn_h
蠃	lu o_l o_l
蠓	m el_l ng_l
蠕	ru u_l u_h
蠡	li i_l i_h
蠡	li i_l i_l
蠢	chu el_l nn_l
血	xi eh_l eh_l
血	xv eh_h eh_l
衄	nv v_h v_l
行	h aa_h ng_l
行	h aa_l ng_h
行	h el_l ng_h
行	xi el_h ng_l
行	xi el_l ng_h
衍	yi a_l nn_l
衔	xi a_l nn_h
街	ji eh_h eh_h
衙	yi a_l a_h
衡	h el_l ng_h
衢	qv v_l v_h
衣	yi i_h i_h
衣	yi i_h i_l
补	bu u_l u_l
补	bu u_m u_m
表	bi aa_l o_l
衩	ch a_h a_l
衩	ch a_l a_l
衫	sh a_h nn_h
衬	ch el_h nn_l
衬	ch el_m nn_m
衮	gu el_l nn_l
衰	cu eh_h i_h
衰	shu a_h eh_h
衲	n a_h a_l
衷	zhu u_h ng_h
衽	r el_h nn_l
衾	qi i_h nn_h
衿	ji i_h nn_h
袁	yv a_l nn_h
袂	m eh_h i_l
袄	aa_l o_l
袅	ni aa_l o_l
袈	ji a_h a_h
袋	d a_h eh_l
袋	d a_m eh_m
袍	p aa_l o_h
袖	xi o_h u_l
袜	wu a_h a_l
袤	m aa_h o_l
被	b eh_h i_l
袭	xi i_l i_h
袱	fu u_l u_h
袱	fu u_m u_m
袷	ji a_l a_h
袷	qi a_h a_h
袼	g el_h el_h
裁	c a_l eh_h
裂	li eh_h eh_l
裂	li eh_l eh_l
装	zhu aa_h ng_h
裆	d aa_h ng_h
裔	yi i_h i_l
裕	yv v_h v_l
裘	qi o_l u_h
裙	qv el_l nn_h
裟	sh a_h a_h
裢	li a_l nn_h
裤	ku u_h u_l
裥	ji a_l nn_l
裱	bi aa_l o_l
裳	ch aa_l ng_h
裳	sh aa_m ng_m
裴	p eh_l i_h
裸	lu o_l o_l
裹	gu o_l o_l
裹	gu o_m o_m
裾	jv v_h v_h
褂	gu a_h a_l
褊	bi a_l nn_l
褐	h el_h el_l
褒	b aa_h o_h
褙	b eh_h i_l
褙	b eh_m i_m
褚	chu u_l u_l
褚	zhu u_l u_l
褛	lv v_l v_l
褡	d a_h a_h
褥	ru u_h u_l
褪	tu eh_h i_l
褪	tu el_h nn_l
褫	ch ib_l ib_l
褶	zh el_l el_l
襄	xi aa_h ng_h
襞	bi i_h i_l
襟	ji i_h nn_h
襻	p a_h nn_l
西	xi i_h i_h
西	xi i_m i_m
要	yi aa_h o_h
要	yi aa_h o_l
覃	qi i_l nn_h
覃	t a_l nn_h
覆	fu u_h u_l
见	ji a_h nn_l
见	ji a_m nn_m
见	xi a_h nn_l
观	gu a_h nn_h
观	gu a_h nn_l
规	gu eh_h i_h
觅	mi i_h i_l
视	sh ib_h ib_l
览	l a_l nn_l
觉	ji aa_h o_l
觉	jv eh_l eh_h
觊	ji i_h i_l
觐	ji i_h nn_l
觑	qv v_h v_h
觑	qv v_h v_l
角	ji aa_l o_l
角	jv eh_l eh_h
觜	z if_h if_h
觜	zu eh_l i_l
觞	sh aa_h ng_h
解	ji eh_h eh_l
解	ji eh_l eh_l
解	xi eh_h eh_l
觥	gu u_h ng_h
触	chu u_h u_l
觫	su u_h u_l
觳	hu u_l u_h
言	yi a_l nn_h
訇	hu u_h ng_h
訾	z if_h if_h
訾	z if_l if_l
詹	zh a_h nn_h
誉	yv v_h v_l
誊	t el_l ng_h
誓	sh ib_h ib_l
謇	ji a_l nn_l
謦	qi el_l ng_l
警	ji el_l ng_l
计	ji i_h i_l
计	ji i_m i_m
订	di el_h ng_l
认	r el_h nn_l
讧	hu u_h ng_l
讨	t aa_l o_l
让	r aa_h ng_l
讪	sh a_h nn_l
讫	qi i_h i_l
训	xv el_h nn_l
训	xv el_m nn_m
议	yi i_h i_l
讯	xv el_h nn_l
记	ji i_h i_l
记	ji i_m i_m
讲	ji aa_l ng_l
讳	hu eh_h i_l
讴	o_h u_h
讶	yi a_h a_l
讷	n el_h el_l
许	hu u_l u_l
许	xv v_l v_l
论	lu el_h nn_l
论	lu el_l nn_h
讼	su u_h ng_l
讽	f el_l ng_l
设	sh el_h el_l
访	f aa_l ng_l
诀	jv eh_l eh_h
证	zh el_h ng_l
诂	gu u_l u_l
诃	h el_h el_h
评	pi el_l ng_h
识	sh ib_l ib_h
识	sh ib_m ib_m
识	zh ib_h ib_l
诈	zh a_h a_l
诉	su u_h u_l
诊	zh el_l nn_l
词	c if_l if_h
诎	qv v_h v_h
诏	zh aa_h o_l
译	yi i_h i_l
诒	d a_h eh_l
诒	yi i_l i_h
试	sh ib_h ib_l
诗	sh ib_h ib_h
诘	ji eh_l eh_h
诘	ji i_l i_h
诚	ch el_l ng_h
诚	ch el_m ng_m
诛	zhu u_h u_h
诜	sh el_h nn_h
话	hu a_h a_l
话	hu a_m a_m
诞	d a_h nn_l
诠	qv a_l nn_h
诡	gu eh_l i_l
询	xv el_l nn_h
诣	yi i_h i_l
诤	zh el_h ng_l
该	g a_h eh_h
详	xi aa_l ng_h
诧	ch a_h a_l
诩	xv v_l v_l
诫	ji eh_h eh_l
语	yv v_h v_l
语	yv v_l v_l
误	wu u_h u_l
诰	g aa_h o_l
诱	yi o_h u_l
诲	hu eh_h i_l
说	shu eh_h i_l
说	shu o_h o_h
说	yv eh_h eh_l
诵	su u_h ng_l
诶	eh_h i_h
诶	eh_h i_l
诶	eh_l i_h
诶	eh_l i_l
诶	xi i_h i_h
请	qi el_l ng_l
诸	zhu u_h u_h
诺	nu o_h o_l
读	d o_h u_l
读	du u_l u_h
课	k el_h el_l
谁	sh eh_l i_h
谁	shu eh_l i_h
调	di aa_h o_l
调	di aa_m o_m
调	ti aa_h o_l
调	ti aa_l o_h
谅	li aa_h ng_l
谆	zhu el_h nn_h
谈	t a_l nn_h
谊	yi i_h i_l
谋	m o_l u_h
谌	ch el_l nn_h
谍	di eh_l eh_h
谎	hu aa_l ng_l
谏	ji a_h nn_l
谐	xi eh_l eh_h
谒	yi eh_h eh_l
谓	wu eh_h i_l
谕	yv v_h v_l
谗	ch a_l nn_h
谘	z if_h if_h
谙	a_h nn_h
谚	yi a_h nn_l
谛	di i_h i_l
谜	m eh_h i_l
谜	mi i_l i_h
谟	mu o_l o_h
谢	xi eh_h eh_l
谣	yi aa_l o_h
谥	sh ib_h ib_l
谦	qi a_h nn_h
谧	mi i_h i_l
谨	ji i_l nn_l
谩	m a_h nn_l
谩	m a_l nn_h
谪	zh el_l el_h
谬	mi o_h u_l
谭	t a_l nn_h
谯	qi aa_h o_l
谯	qi aa_l o_h
谰	l a_l nn_h
谱	pu u_l u_l
谴	qi a_l nn_l
谷	gu u_l u_l
谷	yv v_h v_l
豁	hu a_l a_h
豁	hu o_h o_h
豁	hu o_h o_l
豆	d o_h u_l
豇	ji aa_h ng_h
豉	ch ib_l ib_l
豌	wu a_h nn_h
豕	sh ib_l ib_l
豚	tu el_l nn_h
象	xi aa_h ng_l
豢	hu a_h nn_l
豪	h aa_l o_h
豫	yv v_h v_l
豳	bi i_h nn_h
豸	zh ib_h ib_l
豹	b aa_h o_l
豺	ch a_l eh_h
貂	di aa_h o_h
貅	xi o_h u_h
貉	h aa_l o_h
貉	h el_l el_h
貉	mu o_h o_l
貌	m aa_h o_l
貔	pi i_l i_h
贝	b eh_h i_l
贞	zh el_h nn_h
负	fu u_h u_l
贡	gu u_h ng_l
财	c a_l eh_h
责	z el_l el_h
责	zh a_h eh_l
贤	xi a_h nn_l
贤	xi a_l nn_h
败	b a_h eh_l
账	zh aa_h ng_l
货	hu o_h o_l
质	zh ib_h ib_l
贩	f a_h nn_l
贪	t a_h nn_h
贫	pi i_l nn_h
贬	bi a_l nn_l
购	g o_h u_l
贮	zhu u_h u_l
贯	gu a_h nn_l
贰	er_h er_l
贱	ji a_h nn_l
贲	b el_h nn_h
贲	bi i_h i_l
贴	ti eh_h eh_h
贵	gu eh_h i_l
贶	ku aa_h ng_l
贷	d a_h eh_l
贸	m aa_h o_l
费	f eh_h i_l
贺	h el_h el_l
贻	yi i_l i_h
贼	z eh_l i_h
贽	zh ib_h ib_l
贾	gu u_l u_l
贾	ji a_l a_l
贿	hu eh_h i_l
赁	li i_h nn_l
赂	lu u_h u_l
资	z if_h if_h
赇	qi o_l u_h
赈	zh el_h nn_l
赉	l a_h eh_l
赊	sh el_h el_h
赋	fu u_h u_l
赌	du u_l u_l
赎	shu u_l u_h
赏	sh aa_l ng_l
赐	c if_h if_l
赓	g el_h ng_h
赔	p eh_l i_h
赖	l a_h eh_l
赘	zhu eh_h i_l
赚	zhu a_h nn_l
赚	zu a_h nn_l
赛	s a_h eh_l
赜	z el_l el_h
赞	z a_h nn_l
赠	z el_h ng_l
赡	sh a_h nn_l
赢	yi el_l ng_h
赣	g a_h nn_l
赤	ch ib_h ib_l
赦	sh el_h el_l
赧	n a_l nn_l
赫	h el_h el_l
赭	zh el_l el_l
走	z o_l u_l
赳	ji o_h u_h
赴	fu u_h u_l
赵	zh aa_h o_l
赶	g a_l nn_l
起	qi i_l i_l
趁	ch el_h nn_l
趄	jv v_h v_h
趄	qi eh_h eh_l
趄	qi eh_m eh_m
超	ch aa_h o_h
越	yv eh_h eh_l
趋	qv v_h v_h
趔	li eh_h eh_l
趟	t aa_h ng_h
趟	t aa_h ng_l
趣	qv v_h v_l
足	zu u_l u_h
趴	p a_h a_h
趵	b aa_h o_l
趵	bu o_h o_h
趸	du el_l nn_l
趺	fu u_h u_h
趾	zh ib_l ib_l
趿	t a_h a_h
跃	yv eh_h eh_l
跄	qi aa_h ng_h
跄	qi aa_h ng_l
跆	t a_l eh_h
跋	b a_l a_h
跌	di eh_h eh_h
跎	tu o_l o_h
跑	p aa_l o_h
跑	p aa_l o_l
跗	fu u_h u_h
跛	bu o_l o_l
距	jv v_h v_l
跞	li i_h i_l
跞	lu o_h o_l
跟	g el_h nn_h
跟	g el_m nn_m
跤	ji aa_h o_h
跨	ku a_h a_l
跪	gu eh_h i_l
跫	qv u_l ng_h
跬	ku eh_l i_l
路	lu u_h u_l
跳	ti aa_h o_l
践	ji a_h nn_l
践	ji a_m nn_m
跷	qi aa_h o_h
跸	bi i_h i_l
跺	du o_h o_l
跻	ji i_h i_h
跽	ji i_h i_l
踅	xv eh_l eh_h
踊	yi u_l ng_l
踏	t a_h a_h
踏	t a_h a_l
踏	t a_m a_m
踔	chu o_h o_h
踝	hu a_l eh_h
踞	jv v_h v_l
踢	ti i_h i_h
踩	c a_l eh_l
踪	zu u_h ng_h
踵	zhu u_l ng_l
踹	chu a_h eh_l
蹀	di eh_l eh_h
蹄	ti i_l i_h
蹇	ji a_l nn_l
蹈	d aa_l o_l
蹊	qi i_h i_h
蹊	qi i_m i_m
蹊	xi i_h i_h
蹋	t a_h a_l
蹑	ni eh_h eh_l
蹦	b el_h ng_l
蹬	d el_h ng_h
蹬	d el_h ng_l
蹬	d el_m ng_m
蹭	c el_h ng_l
蹭	c el_m ng_m
蹰	chu u_l u_h
蹲	cu el_l nn_h
蹲	du el_h nn_h
蹴	cu u_h u_l
蹴	ji o_m u_m
躁	z aa_h o_l
身	sh el_h nn_h
躬	gu u_h ng_h
躲	du o_l o_l
躺	t aa_l ng_l
车	ch el_h el_h
车	jv v_h v_h
轧	g a_l a_h
轧	yi a_h a_l
轧	zh a_l a_h
轨	gu eh_l i_l
轩	xv a_h nn_h
转	zhu a_h nn_l
转	zhu a_l eh_l
转	zhu a_l nn_l
轭	el_h el_l
轮	lu el_l nn_h
软	ru a_l nn_l
轰	hu u_h ng_h
轱	gu u_h u_h
轲	k el_h el_h
轲	k el_l el_l
轳	lu u_l u_h
轳	lu u_m u_m
轴	zh o_h u_l
轴	zh o_l u_h
轵	zh ib_l ib_l
轶	yi i_h i_l
轸	zh el_l nn_l
轺	yi aa_l o_h
轻	qi el_h ng_h
轼	sh ib_h ib_l
载	z a_h eh_l
载	z a_l eh_l
轾	zh ib_h ib_l
轿	ji aa_h o_l
辁	qv a_l nn_h
辂	lu u_h u_l
较	ji aa_h o_l
辄	zh el_l el_h
辅	fu u_l u_l
辆	li aa_h ng_l
辇	ni a_l nn_l
辈	b eh_h i_l
辉	hu eh_h i_h
辊	gu el_l nn_l
辋	wu aa_l ng_l
辏	c o_h u_l
辐	fu u_l u_h
辑	ji i_l i_h
输	shu u_h u_h
辕	yv a_l nn_h
辖	h el_l el_h
辖	xi a_l a_h
辗	ni a_l nn_l
辗	zh a_l nn_l
辘	lu u_h u_l
辘	lu u_m u_m
辙	zh el_l el_h
辚	li i_l nn_h
辛	xi i_h nn_h
辜	gu u_h u_h
辞	c if_l if_h
辟	bi i_h i_l
辟	pi i_h i_h
辟	pi i_h i_l
辣	l a_h a_l
辨	bi a_h nn_l
辩	bi a_h nn_l
辫	bi a_h nn_l
辰	ch el_l nn_h
边	bi a_h nn_h
边	bi a_m nn_m
辽	li aa_l o_h
达	d a_l a_h
达	d a_m a_m
迁	qi a_h nn_h
迂	yv v_h v_h
迄	qi i_h i_l
迅	xv el_h nn_l
过	gu o_h o_h
过	gu o_h o_l
过	gu o_m o_m
迈	m a_h eh_l
迎	yi el_l ng_h
运	yv el_h nn_l
近	ji i_h nn_l
迓	yi a_h a_l
返	f a_l nn_l
还	h a_l eh_h
还	hu a_l nn_h
这	zh eh_h i_l
这	zh el_h el_l
进	ji i_h nn_l
远	yv a_h nn_l
远	yv a_l nn_l
违	wu eh_l i_h
连	li a_l nn_h
迟	ch ib_l ib_h
迢	ti aa_l o_h
迤	yi i_l i_h
迤	yi i_l i_l
迥	jv u_l ng_l
迦	ji a_h a_h
迩	er_l er_l
迪	di i_l i_h
迫	p a_l eh_l
迫	pu o_h o_l
迭	di eh_l eh_h
迮	z el_l el_h
述	shu u_h u_l
迳	ji el_h ng_l
迷	mi i_h i_h
迷	mi i_l i_h
迸	b el_h ng_l
迸	p el_h ng_h
迹	ji i_h i_l
追	zhu eh_h i_h
退	tu eh_h i_l
送	su u_h ng_l
适	ku o_h o_l
适	sh ib_h ib_l
逃	t aa_l o_h
逄	p aa_l ng_h
逅	h o_h u_l
逆	ni i_h i_l
选	shu a_h a_h
选	su a_h nn_l
选	xv a_h nn_l
选	xv a_l nn_l
逊	xv el_h nn_l
逍	xi aa_h o_h
透	t o_h u_l
逐	zhu u_l u_h
逑	qi o_l u_h
递	di i_h i_l
途	tu u_l u_h
逖	ti i_h i_l
逗	d o_h u_l
通	tu u_h ng_h
通	tu u_h ng_l
逛	gu aa_h ng_l
逝	sh ib_h ib_l
逞	ch el_l ng_l
速	su u_h u_l
造	z aa_h o_l
逢	f el_l ng_h
逦	li i_l i_l
逮	d a_h eh_l
逮	d a_l eh_l
逯	lu u_h u_l
逵	ku eh_l i_h
逶	wu eh_h i_h
逸	yi i_h i_l
逻	lu o_l o_h
逼	bi i_h i_h
逾	yv v_l v_h
遁	du el_h nn_l
遂	su eh_h i_l
遂	su eh_l i_h
遄	chu a_l nn_h
遇	yv v_h v_l
遍	bi a_h nn_l
遏	el_h el_l
遐	xi a_l a_h
遒	qi o_l u_h
道	d aa_h o_h
道	d aa_h o_l
道	d aa_m o_m
遗	wu eh_h i_l
遗	yi i_l i_h
遛	li o_h u_l
遛	li o_l u_h
遢	t a_h a_h
遣	qi a_l nn_l
遥	yi aa_l o_h
遨	aa_l o_h
遭	z aa_h o_h
遮	zh el_h el_h
遵	zu el_h nn_h
避	bi i_h i_l
邀	yi aa_h o_h
邂	xi eh_h eh_l
邃	su eh_h i_l
邈	mi aa_l o_l
邋	l a_h a_h
邑	yi i_h i_l
邓	d el_h ng_l
邕	yi u_h ng_h
邗	h a_l nn_h
邙	m aa_l ng_h
邛	qv u_l ng_h
邝	ku aa_h ng_l
邡	f aa_h ng_h
邢	g el_l ng_l
邢	xi el_l ng_h
那	n a_h a_h
那	n a_h a_l
那	n a_l a_l
那	n eh_h i_l
那	n el_h el_l
邦	b aa_h ng_h
邪	xi eh_l eh_h
邪	yi eh_l eh_h
邬	wu u_h u_h
邮	yi o_l u_h
邯	h a_l nn_h
邰	t a_l eh_h
邱	qi o_h u_h
邳	pi i_h i_h
邴	bi el_l ng_l
邵	sh aa_h o_l
邶	b eh_h i_l
邸	di i_l i_l
邹	jv v_h v_l
邹	z o_h u_h
邺	yi eh_h eh_l
邻	li i_l nn_h
邾	zhu u_h u_h
郁	yv v_h v_l
郄	qi eh_h eh_l
郄	xi i_h i_l
郅	zh ib_h ib_l
郇	hu a_l nn_h
郇	xv el_l nn_h
郊	ji aa_h o_h
郎	l aa_h ng_l
郎	l aa_l ng_h
郎	l aa_m ng_m
郏	ji a_l a_h
郐	ku a_h eh_l
郑	zh el_h ng_l
郓	yv el_h nn_l
郗	ch ib_h ib_h
郗	xi i_h i_h
郛	fu u_l u_h
郜	g aa_h o_l
郝	h aa_l o_l
郡	jv el_h nn_l
郢	yi el_l ng_l
郦	li i_h i_l
郧	yv el_l nn_h
部	bu u_h u_l
郫	pi i_l i_h
郭	gu o_h o_h
郯	t a_l nn_h
郴	ch el_h nn_h
郸	d a_h nn_h
都	d o_h u_h
都	du u_h u_h
郾	yi a_l nn_l
鄂	el_h el_l
鄄	jv a_h nn_l
鄙	bi i_l i_l
鄞	yi i_l nn_h
鄢	yi a_h nn_h
鄣	zh aa_h ng_h
鄯	sh a_h nn_l
鄱	pu o_l o_h
鄹	z o_h u_h
酃	li el_l ng_h
酆	f el_h ng_h
酉	yi o_l u_l
酊	di el_h ng_h
酊	di el_l ng_l
酋	qi o_l u_h
酌	zhu o_l o_h
配	p eh_h i_l
酎	zh o_h u_l
酒	ji o_l u_l
酚	f el_h nn_h
酝	yv el_h nn_l
酢	cu u_h u_l
酢	zu o_h o_l
酣	h a_h nn_h
酤	gu u_h u_h
酥	su u_h u_h
酩	mi el_l ng_l
酪	l aa_h o_l
酬	ch o_l u_h
酬	ch o_m u_m
酮	tu u_l ng_h
酯	zh ib_l ib_l
酰	xi a_h nn_h
酱	ji aa_h ng_l
酵	ji aa_h o_l
酶	m eh_l i_h
酷	ku u_h u_l
酸	su a_h nn_h
酹	l eh_h i_l
酽	yi a_h nn_l
酿	ni aa_h ng_l
酿	ni aa_l ng_h
醅	p eh_h i_h
醇	chu el_l nn_h
醉	zu eh_h i_l
醋	cu u_h u_l
醍	ti i_l i_h
醐	hu u_l u_h
醒	xi el_l ng_l
醚	mi i_l i_h
醛	qv a_l nn_h
醢	h a_l eh_l
醣	t aa_l ng_h
醪	l aa_l o_h
醮	ji aa_h o_l
醴	li i_l i_l
醺	xv el_h nn_h
采	c a_h eh_l
采	c a_l eh_l
釉	yi o_h u_l
释	sh ib_h ib_l
里	li i_l i_l
里	li i_m i_m
重	chu u_l ng_h
重	zhu u_h ng_l
野	yi eh_l eh_l
量	li aa_h ng_l
量	li aa_l ng_h
量	li aa_m ng_m
金	ji i_h nn_h
釜	fu u_l u_l
鉴	ji a_h nn_l
銮	lu a_l nn_h
鋈	wu u_h u_l
錾	z a_h nn_l
鎏	li o_l u_h
鏊	aa_h o_l
鏖	aa_l o_h
鑫	xi i_h nn_h
钇	yi i_l i_l
针	zh el_h nn_h
钉	di el_h ng_h
钉	di el_h ng_l
钉	di el_m ng_m
钊	zh aa_h o_h
钍	tu u_l u_l
钎	qi a_h nn_h
钏	chu a_h nn_l
钐	sh a_h nn_h
钐	sh a_h nn_l
钒	f a_l nn_h
钓	di aa_h o_l
钔	m el_l nn_h
钕	nv v_l v_l
钗	ch a_h eh_h
钙	g a_h eh_l
钛	t a_h eh_l
钜	jv v_h v_l
钝	du el_h nn_l
钞	ch aa_h o_h
钞	mi aa_l o_l
钟	zhu u_h ng_h
钟	zhu u_m ng_m
钠	n a_h a_l
钡	b eh_h i_l
钢	g aa_h ng_h
钢	g aa_h ng_l
钣	b a_l nn_l
钤	qi a_l nn_h
钥	yi aa_h o_l
钥	yv eh_h eh_l
钦	qi i_h nn_h
钧	jv el_h nn_h
钨	wu u_h u_h
钩	g o_h u_h
钫	f aa_h ng_h
钬	hu o_l o_l
钭	d o_l u_l
钭	t o_l u_l
钮	ni o_l u_l
钯	b a_h a_h
钯	b a_l a_l
钯	p a_l a_h
钰	yv v_h v_l
钱	qi a_l nn_h
钱	qi a_m nn_m
钲	zh el_h ng_h
钳	qi a_l nn_h
钴	gu u_l u_l
钵	bu o_h o_h
钶	k el_h el_h
钸	bu u_h u_h
钹	bu o_l o_h
钺	yv eh_h eh_l
钻	zu a_h nn_h
钻	zu a_h nn_l
钼	mu u_h u_l
钽	t a_l nn_l
钾	ji a_l a_l
钿	di a_h nn_l
钿	ti a_l nn_h
铀	yi o_l u_h
铁	ti eh_l eh_l
铁	ti eh_m eh_m
铂	bu o_l o_h
铃	li el_l ng_h
铄	shu o_h o_l
铅	qi a_h nn_h
铅	yi a_l nn_h
铆	m aa_l o_l
铈	sh ib_h ib_l
铉	xv a_h nn_l
铊	t a_h a_h
铊	tu o_l o_h
铋	bi i_h i_l
铌	ni i_l i_h
铍	pi i_h i_h
铍	pi i_l i_h
铎	du o_l o_h
铐	k aa_h o_l
铑	l aa_l o_h
铑	l aa_l o_l
铒	er_l er_l
铕	yi o_l u_l
铖	ch el_l ng_h
铘	yi eh_l eh_h
铙	n aa_l o_h
铛	ch el_h ng_h
铛	d aa_h ng_h
铛	d aa_m ng_m
铜	tu u_l ng_h
铝	lv v_l v_l
铞	di aa_h o_l
铟	yi i_h nn_h
铠	k a_l eh_l
铡	zh a_l a_h
铢	zhu u_h u_h
铣	xi a_l nn_l
铣	xi i_l i_l
铤	di el_h ng_l
铤	ti el_l ng_l
铧	hu a_l a_h
铨	qv a_l nn_h
铪	h a_h a_h
铫	di aa_h o_l
铫	yi aa_l o_h
铬	g el_h el_l
铭	mi el_l ng_h
铮	zh el_h ng_h
铮	zh el_h ng_l
铯	s el_h el_l
铰	ji aa_l o_l
铱	yi i_h i_h
铲	ch a_l nn_l
铳	chu u_h ng_l
铵	a_l nn_l
银	yi i_l nn_h
铷	ru u_l u_h
铸	zhu u_h u_l
铹	l aa_l o_h
铹	l aa_l o_l
铺	pu u_h u_h
铺	pu u_h u_l
铼	l a_l eh_h
链	li a_h nn_l
铿	k el_h ng_h
销	xi aa_h o_h
锁	su o_l o_l
锂	li i_l i_l
锃	z el_h ng_h
锃	z el_h ng_l
锄	chu u_l u_h
锅	gu o_h o_h
锆	g aa_h o_l
锈	xi o_h u_l
锉	cu o_h o_l
锋	f el_h ng_h
锌	xi i_h nn_h
锍	li o_l u_l
锎	k a_h eh_h
锏	ji a_h nn_l
锏	ji a_l nn_l
锐	ru eh_h i_l
锑	ti i_h i_h
锒	l aa_l ng_h
锒	li aa_l ng_h
锓	qi i_l nn_l
锔	jv v_h v_h
锔	jv v_l v_h
锕	a_h a_h
锖	qi aa_h ng_h
锗	du u_l u_l
锗	zh el_l el_l
锘	nu o_h o_l
错	cu o_h o_l
锚	m aa_l o_h
锛	b el_h nn_h
锝	d el_l el_h
锞	k el_h el_l
锟	ku el_h nn_h
锡	xi i_h i_h
锢	gu u_h u_l
锣	lu o_l o_h
锤	chu eh_l i_h
锥	zhu eh_h i_h
锦	ji i_l nn_l
锨	xi a_h nn_h
锩	jv a_l nn_l
锪	hu o_h o_h
锬	t a_l nn_h
锬	xi a_h nn_h
锭	di el_h ng_l
键	ji a_h nn_l
锯	jv v_h v_h
锯	jv v_h v_l
锰	m el_l ng_l
锲	qi eh_h eh_l
锴	k a_l eh_l
锵	qi aa_h ng_h
锶	s if_h if_h
锷	el_h el_l
锹	qi aa_h o_h
锺	zhu u_h ng_h
锻	du a_h nn_l
锾	hu a_l nn_h
镀	du u_h u_l
镁	m eh_l i_l
镂	l o_h u_l
镅	m eh_l i_h
镆	mu o_h o_l
镇	zh el_h nn_h
镇	zh el_h nn_l
镉	g el_l el_h
镌	jv a_h nn_h
镍	ni eh_h eh_l
镏	li o_h u_l
镏	li o_l u_h
镐	g aa_l o_l
镐	h aa_h o_l
镑	b aa_h ng_l
镑	p aa_h ng_h
镒	yi i_h i_l
镓	ji a_h a_h
镔	bi i_h nn_h
镕	ru u_l ng_h
镖	bi aa_h o_h
镗	t aa_h ng_h
镗	t aa_l ng_h
镘	m a_h nn_l
镙	lu o_l o_h
镛	yi u_h ng_h
镜	ji el_h ng_l
镝	di i_h i_h
镝	di i_l i_h
镞	chu o_h o_l
镞	zu u_l u_h
镟	xv a_h nn_l
镡	ch a_l nn_h
镡	t a_l nn_h
镡	xi i_l nn_h
镤	pu u_l u_h
镥	lu u_l u_h
镥	lu u_l u_l
镦	du eh_h i_l
镦	du el_h nn_h
镧	l a_l nn_h
镨	pu u_l u_l
镩	cu a_h nn_h
镪	qi aa_h ng_h
镪	qi aa_l ng_l
镫	d el_h ng_l
镬	hu o_h o_l
镭	l eh_l i_h
镯	zhu o_l o_h
镰	li a_l nn_h
镱	yi i_h i_l
镳	bi aa_h o_h
镶	r aa_l ng_h
镶	xi aa_h ng_h
长	ch aa_l ng_h
长	zh aa_l ng_l
门	m el_l nn_h
闩	shu a_h nn_h
闪	sh a_l nn_l
闪	sh a_m nn_m
闫	yi a_l nn_h
闭	bi i_h i_l
问	wu el_h nn_l
闯	chu aa_l ng_l
闰	ru el_h nn_l
闱	wu eh_l i_h
闲	xi a_l nn_h
闳	hu u_l ng_h
间	ji a_h nn_h
间	ji a_h nn_l
闵	mi i_l nn_l
闷	m el_h nn_h
闷	m el_h nn_l
闷	m el_m nn_m
闸	zh a_l a_h
闹	n aa_h o_l
闹	n aa_m o_m
闺	gu eh_h i_h
闻	wu el_l nn_h
闼	t a_h a_l
闽	mi i_l nn_l
闾	lv v_l v_h
阀	f a_l a_h
阁	g el_l el_h
阄	ji o_h u_h
阅	yv eh_h eh_l
阆	l aa_h ng_l
阆	l aa_l ng_h
阉	yi a_h nn_h
阊	ch aa_h ng_h
阋	xi i_h i_l
阌	wu el_l nn_h
阎	yi a_l nn_h
阎	yi a_l nn_l
阐	ch a_l nn_l
阑	l a_l nn_h
阔	ku o_h o_l
阕	qv eh_h eh_l
阖	h el_l el_h
阗	ti a_l nn_h
阙	qv eh_h eh_h
阙	qv eh_h eh_l
阚	h a_l nn_l
阚	k a_h nn_l
阜	fu u_h u_l
阝	fu u_l u_l
阝	zu o_l o_l
队	du eh_h i_l
阡	qi a_h nn_h
阪	b a_l nn_l
阮	ru a_l nn_l
阱	ji el_l ng_l
防	f aa_l ng_h
阳	yi aa_l ng_h
阴	yi i_h nn_h
阵	zh el_h nn_l
阶	ji eh_h eh_h
阻	zu u_l u_l
阽	di a_h nn_l
阽	yi a_l nn_h
阿	a_h a_h
阿	a_m a_m
阿	el_h el_h
陀	tu o_l o_h
陂	b eh_h i_h
陂	pi i_l i_h
陂	pu o_h o_h
附	fu u_h u_l
际	ji i_h i_l
陆	li o_h u_l
陆	lu u_h u_l
陇	lu u_l ng_l
陈	ch el_l nn_h
陉	ji el_h ng_l
陉	xi el_l ng_h
陋	l o_h u_l
陌	mu o_h o_l
降	ji aa_h ng_l
降	xi aa_l ng_h
限	xi a_h nn_l
陔	g a_h eh_h
陕	sh a_l nn_l
陛	bi i_h i_l
陟	zh ib_h ib_l
陡	d o_l u_l
院	yv a_h nn_l
除	chu u_l u_h
陧	ni eh_h eh_l
陨	yv el_l nn_l
险	xi a_l nn_l
陪	p eh_l i_h
陬	z o_h u_h
陲	chu eh_l i_h
陵	li el_l ng_h
陶	t aa_l o_h
陶	yi aa_l o_h
陷	xi a_h nn_l
隅	yv v_l v_h
隆	lu u_h ng_h
隆	lu u_l ng_h
隆	lu u_m ng_m
隈	wu eh_h i_h
隋	su eh_l i_h
隍	hu aa_l ng_h
随	su eh_l i_h
隐	yi i_h nn_l
隐	yi i_l nn_l
隔	g el_l el_h
隗	ku eh_l i_h
隗	wu eh_l i_l
隘	a_h eh_l
隙	xi i_h i_l
障	zh aa_h ng_l
隧	su eh_h i_l
隰	xi i_l i_h
隳	hu eh_h i_h
隶	li i_h i_l
隹	cu eh_h i_h
隹	zhu eh_h i_h
隼	su el_l nn_l
隽	jv a_h nn_l
隽	jv el_h nn_l
难	n a_h nn_l
难	n a_l nn_h
难	n a_m nn_m
雀	qi aa_h o_h
雀	qi aa_l o_l
雀	qv eh_h eh_l
雁	yi a_h nn_l
雄	xv u_l ng_h
雅	yi a_h a_h
雅	yi a_l a_l
集	ji i_l i_h
雇	gu u_h u_l
雉	zh ib_h ib_l
雌	c if_l if_h
雍	yi u_h ng_h
雎	jv v_h v_h
雏	chu u_l u_h
雒	lu o_h o_l
雕	di aa_h o_h
雨	yv v_h v_l
雨	yv v_l v_l
雩	yv v_l v_h
雪	xv eh_l eh_l
雯	wu el_l nn_h
雳	li i_h i_l
零	li el_l ng_h
0	li el_l ng_h
雷	l eh_l i_h
雹	b aa_l o_h
雾	wu u_h u_l
需	xv v_h v_h
霁	ji i_h i_l
霄	xi aa_h o_h
霆	ti el_l ng_h
震	zh el_h nn_l
霈	p eh_h i_l
霉	m eh_l i_h
霍	hu o_h o_l
霎	sh a_h a_l
霏	f eh_h i_h
霓	ni i_l i_h
霖	li i_l nn_h
霜	shu aa_h ng_h
霞	xi a_l a_h
霭	a_l eh_l
露	l o_h u_l
露	l o_m u_m
露	lu u_h u_l
霸	b a_h a_l
霹	pi i_h i_h
霾	m a_l eh_h
青	qi el_h ng_h
靓	ji el_h ng_l
靓	li aa_h ng_l
靖	ji el_h ng_l
静	ji el_h ng_l
静	ji el_m ng_m
靛	di a_h nn_l
靛	yi i_l nn_l
非	f eh_h i_h
靠	k aa_h o_l
靡	mi i_l i_h
靡	mi i_l i_l
面	mi a_h nn_l
面	mi a_m nn_m
靥	yi eh_h eh_l
革	g el_l el_h
革	ji i_l i_h
靳	ji i_h nn_l
靴	xv eh_h eh_h
靶	b a_l a_l
靼	d a_l a_h
鞅	yi aa_h ng_h
鞅	yi aa_h ng_l
鞋	xi eh_l eh_h
鞍	a_h nn_h
鞑	d a_l a_h
鞘	qi aa_h o_l
鞘	sh aa_h o_h
鞠	jv v_h v_h
鞭	bi a_h nn_h
鞲	g o_h u_h
韦	wu eh_l i_h
韧	r el_h nn_l
韩	h a_l nn_h
韫	yv el_h nn_l
韬	t aa_h o_h
韭	ji o_l u_l
音	yi i_h nn_h
韵	yv el_h nn_l
韶	sh aa_l o_h
页	xi eh_l eh_h
页	yi eh_h eh_l
顶	di el_l ng_l
顷	qi el_l ng_l
项	xi aa_h ng_l
项	xi aa_m ng_m
顺	shu el_h nn_l
须	xv v_h v_h
顼	xv v_h v_h
顽	wu a_l nn_h
顾	gu u_h u_l
顿	du el_h nn_l
顿	du u_l u_h
颀	qi i_l i_h
颁	b a_h nn_h
颁	f el_l nn_h
颂	su u_h ng_l
预	yv v_h v_l
颅	lu u_l u_h
领	li el_l ng_l
颇	pu o_h o_h
颈	g el_l ng_l
颈	ji el_l ng_l
颉	ji eh_l eh_h
颉	xi eh_l eh_h
颊	ji a_l a_h
颌	g el_l el_h
颌	h el_l el_h
颍	yi el_l ng_l
颐	yi i_l i_h
频	pi i_l nn_h
颓	tu eh_l i_h
颖	yi el_l ng_l
颗	k el_h el_h
题	ti i_l i_h
颚	el_h el_l
颛	zhu a_h nn_h
颜	yi a_l nn_h
额	el_l el_h
颞	ni eh_h eh_l
颠	di a_h nn_h
颡	s aa_l ng_l
颢	h aa_h o_l
颤	ch a_h nn_l
颤	zh a_h nn_l
颦	pi i_l nn_h
颧	qv a_l nn_h
风	f el_h ng_h
飒	s a_h a_l
飓	jv v_h v_l
飕	s o_h u_h
飘	pi aa_h o_h
飙	bi aa_h o_h
飚	bi aa_h o_h
飞	f eh_h i_h
食	sh ib_l ib_h
食	sh ib_m ib_m
食	s if_h if_l
食	yi i_h i_l
飧	su el_h nn_h
飨	xi aa_l ng_l
餐	c a_h nn_h
餮	ti eh_h eh_l
饕	t aa_h o_h
饣	sh ib_h ib_l
饣	sh ib_l ib_h
饥	ji i_h i_h
饧	t aa_l ng_h
饧	xi el_l ng_h
饨	tu el_l nn_h
饪	r el_h nn_l
饬	ch ib_h ib_l
饭	f a_h nn_l
饮	yi i_h nn_l
饮	yi i_l nn_l
饯	ji a_h nn_l
饰	sh ib_h ib_l
饱	b aa_l o_l
饲	s if_h if_l
饴	yi i_l i_h
饵	er_l er_l
饶	r aa_l o_h
饷	xi aa_l ng_l
饺	ji aa_l o_l
饼	bi el_l ng_l
饼	bi el_m ng_m
饽	bu o_h o_h
饽	bu o_m o_m
饿	el_h el_l
馀	yv v_l v_h
馄	hu el_l nn_h
馅	xi a_h nn_l
馆	gu a_l nn_l
馇	ch a_h a_h
馇	zh a_m a_m
馈	ku eh_h i_l
馋	ch a_l nn_h
馍	mu o_l o_h
馏	li o_h u_l
馏	li o_l u_h
馐	xi o_h u_h
馒	m a_l nn_h
馓	s a_l nn_l
馔	zhu a_h nn_l
馕	n aa_l ng_h
馕	n aa_l ng_l
首	sh o_l u_l
馗	ku eh_l i_h
馘	gu o_l o_h
香	xi aa_h ng_h
馥	fu u_h u_l
馨	xi i_h nn_h
马	m a_l a_l
驭	yv v_h v_l
驮	du o_h o_l
驮	tu o_l o_h
驯	xv el_h nn_l
驰	ch ib_l ib_h
驱	qv v_h v_h
驳	bu o_l o_h
驴	lv v_l v_h
驶	sh ib_l ib_l
驷	s if_h if_l
驸	fu u_h u_l
驹	jv v_h v_h
驹	jv v_h v_l
驻	zhu u_h u_l
驼	tu o_l o_h
驽	nu u_l u_h
驾	ji a_h a_l
驿	yi i_h i_l
骀	d a_h eh_l
骀	t a_l eh_h
骁	xi aa_h o_h
骂	m a_h a_l
骄	ji aa_h o_h
骅	hu a_l a_h
骆	ji a_h a_l
骆	lu o_h o_l
骇	h a_h eh_l
骈	pi a_l nn_h
骊	li i_l i_h
骋	ch el_l ng_l
验	yi a_h nn_l
骏	jv el_h nn_l
骐	qi i_l i_h
骑	ji i_h i_l
骑	qi i_l i_h
骓	zhu eh_h i_h
骖	c a_h nn_h
骗	pi a_h nn_l
骚	s aa_h o_h
骛	wu u_h u_l
骜	aa_h o_l
骝	li o_l u_h
骞	ji a_l nn_l
骞	qi a_h nn_h
骟	sh a_h nn_l
骠	bi aa_h o_h
骠	pi aa_h o_l
骡	lu o_l o_h
骢	cu u_h ng_h
骣	ch a_l nn_l
骤	zh o_h u_l
骥	ji i_h i_l
骧	xi aa_h ng_h
骨	gu u_h u_h
骨	gu u_l u_l
骨	gu u_m u_m
骰	t o_l u_h
骱	ji eh_h eh_l
骶	di i_l i_l
骷	ku u_h u_h
骺	h o_l u_h
骼	g el_l el_h
髅	l o_l u_h
髋	ku a_h nn_h
髌	bi i_h nn_l
髑	du u_l u_h
髓	su eh_l i_l
高	g aa_h o_h
髟	bi aa_h o_h
髟	pi aa_h o_l
髟	sh a_h nn_h
髦	m aa_l o_h
髯	r a_l nn_h
髻	ji i_h i_l
鬃	zu u_h ng_h
鬓	bi i_h nn_l
鬲	g el_l el_h
鬲	li i_h i_l
鬼	gu eh_l i_l
魁	ku eh_l i_h
魂	hu el_l nn_h
魄	bu o_l o_h
魄	pu o_h o_l
魄	tu o_h o_l
魅	m eh_h i_l
魇	yi a_l nn_l
魈	xi aa_h o_h
魏	wu eh_h i_l
魔	mu o_l o_h
鱼	yv v_l v_h
鱿	yi o_l u_h
鲁	lu u_l u_l
鲂	f aa_l ng_h
鲅	b a_h a_l
鲆	pi el_l ng_h
鲇	ni a_l nn_h
鲈	lu u_l u_h
鲍	b aa_h o_l
鲎	h o_h u_l
鲑	gu eh_h i_h
鲑	xi eh_l eh_h
鲒	ji eh_l eh_h
鲔	wu eh_l i_l
鲛	ji aa_h o_h
鲜	xi a_h nn_h
鲜	xi a_l nn_l
鲟	xv el_l nn_h
鲡	li i_l i_h
鲢	li a_l nn_h
鲤	li i_l i_l
鲥	sh ib_l ib_h
鲨	sh a_h a_h
鲩	hu a_h nn_l
鲫	ji i_h i_l
鲭	qi el_h ng_h
鲭	zh el_h ng_h
鲮	li el_l ng_h
鲱	f eh_h i_h
鲲	ku el_h nn_h
鲳	ch aa_h ng_h
鲵	ni i_l i_h
鲶	ni a_l nn_h
鲷	di aa_h o_h
鲸	ji el_h ng_h
鲽	di eh_l eh_h
鳃	s a_h eh_h
鳃	xi i_l i_l
鳄	el_h el_l
鳅	qi o_h u_h
鳇	hu aa_l ng_h
鳊	bi a_h nn_h
鳋	s aa_h o_h
鳌	aa_l o_h
鳍	qi i_l i_h
鳔	bi aa_h o_l
鳕	xv eh_l eh_l
鳖	bi eh_h eh_h
鳗	m a_l nn_h
鳘	mi i_l nn_l
鳙	yi u_h ng_h
鳜	gu eh_h i_l
鳝	sh a_h nn_l
鳞	li i_l nn_h
鳟	zu el_h nn_h
鳣	sh a_h nn_l
鳣	zh a_h nn_h
鸟	di aa_l o_l
鸟	ni aa_l o_l
鸠	ji o_h u_h
鸡	ji i_h i_h
鸢	yv a_h nn_h
鸣	mi el_l ng_h
鸥	o_h u_h
鸦	yi a_h a_h
鸨	b aa_l o_l
鸩	zh el_h nn_l
鸪	gu u_h u_h
鸫	du u_h ng_h
鸬	lu u_l u_h
鸭	yi a_h a_h
鸯	yi aa_h ng_h
鸳	yv a_h nn_h
鸵	tu o_l o_h
鸶	s if_h if_h
鸷	zh ib_h ib_l
鸸	er_l er_h
鸹	gu a_h a_h
鸺	xi o_h u_h
鸽	g el_h el_h
鸾	lu a_l nn_h
鸿	hu u_l ng_h
鹁	bu o_l o_h
鹂	li i_l i_h
鹃	jv a_h nn_h
鹄	gu u_l u_l
鹄	hu u_l u_h
鹅	el_l el_h
鹆	yv v_h v_l
鹇	xi a_l nn_h
鹈	ti i_l i_h
鹉	wu u_l u_l
鹊	qv eh_h eh_l
鹋	mi aa_l o_h
鹌	a_h nn_h
鹏	p el_l ng_h
鹑	chu el_l nn_h
鹕	hu u_l u_h
鹗	el_h el_l
鹘	gu u_l u_l
鹘	hu u_l u_h
鹚	c if_l if_h
鹛	m eh_l i_h
鹜	wu u_h u_l
鹞	yi aa_h o_l
鹤	h el_h el_l
鹦	yi el_h ng_h
鹧	zh el_h el_l
鹩	li aa_l o_h
鹫	ji o_h u_l
鹭	lu u_h u_l
鹰	yi el_h ng_h
鹱	hu u_h u_l
鹳	gu a_h nn_l
鹿	lu u_h u_l
麂	ji i_l i_l
麇	jv el_h nn_h
麇	qv el_l nn_h
麋	mi i_l i_h
麒	qi i_l i_h
麓	lu u_h u_l
麝	sh el_h el_l
麟	li i_l nn_h
麦	m a_h eh_l
麦	m a_m eh_m
麴	qv v_h v_h
麸	fu u_h u_h
麻	m a_h a_h
麻	m a_l a_h
麻	m a_m a_m
麽	m el_m el_m
麽	mu o_l o_h
麾	hu eh_h i_h
黄	hu aa_l ng_h
黉	hu u_l ng_h
黍	shu u_l u_l
黎	li i_l i_h
黏	ni a_l nn_h
黑	h eh_h i_h
黔	qi a_l nn_h
默	mu o_h o_l
黛	d a_h eh_l
黜	chu u_h u_l
黟	yi i_h i_h
黠	xi a_l a_h
黩	du u_l u_h
黪	c a_l nn_l
黯	a_h nn_l
黹	zh ib_l ib_l
黼	fu u_l u_l
黾	mi a_l nn_l
黾	mi i_l nn_l
鼋	yv a_l nn_h
鼍	tu o_l o_h
鼎	di el_l ng_l
鼐	n a_h eh_l
鼓	gu u_l u_l
鼓	gu u_m u_m
鼗	t aa_l o_h
鼙	pi i_l i_h
鼠	shu u_l u_l
鼯	wu u_l u_h
鼷	xi i_h i_h
鼹	yi a_l nn_l
鼻	bi i_l i_h
鼾	h a_h nn_h
齄	zh a_h a_h
齐	ji i_h i_l
齐	qi i_l i_h
齿	ch ib_l ib_l
龃	jv v_l v_l
龄	li el_l ng_h
龅	b aa_h o_h
龆	ti aa_l o_h
龉	yv v_l v_l
龙	lu u_l ng_h
龚	gu u_h ng_h
龛	k a_h nn_h
龟	gu eh_h i_h
龟	jv el_h nn_h
龟	qi o_h u_h
